border_size=1
usage=map

Xos, Xos, Xos, Xos, Xos, Xos, Xos, Xos, Xos, Xos, Xos, Xos, Xos, Xos, Xos, Xos, Xos, Xos, Xos, Xos, Xos, Xos, Xos, Xos, Xos, Rr, Rrc, Rr, Xos, Xos, Xos, Xos, Xos, Xos, Xos, Xos, Xos, Xos, Xos, Xos, Xos, Xos, Xos, Xos, Xos, Xos
Xos, Xos, Xos, Xos, Xos, Xos, Xos, Xos, Xos, Xos, Xos, Xos, Xos, Xos, Xos, Xos, Xos, Xos, Xos, Xos, Xos, Xos, Xos, Xos, Xos, Rr, Rrc, Rr, Xos, Xos, Xos, Xos, Xos, Xos, Xu, Xu, Xu, Xos, Xu, Xos, Xos, Xos, Xos, Xos, Xos, Xos
Xos, Xos, Xos, Xos, Xos, Xos, Xos, Xos, Xos, Xos, Xos, Xos, Xos, Xos, Xos, Xos, Xos, Xos, Xos, Xos, Xos, Xos, Xos, Xos, Xos, Rr, Rrc, Rr, Xos, Xos, Xos, Xos, Xos, Xu, Hhd, Hhd, Hhd, Xu, Hhd, Xu, Xu, Xos, Xos, Xos, Xos, Xos
Xos, Xos, Xos, Xos, Xu, Xu, Xu, Xu, Xu, Xos, Xu, Xu, Xu, Xu, Xu, Xos, Xu, Xos, Xos, Xos, Xos, Xos, Xos, Xos, Xos, Rr, Rrc, Rr, Xos, Xos, Xos, Xos, Xu, Xu, Hhd, Mm^Vhh, Hhd^Srg, Re, Re, Hhd, Re, Xu, Xos, Xos, Xos, Xos
Xos, Xos, Xu, Xu, Qlfz, Qlfz, Rd, Hd, Hd, Xu, Xu, Xu, Qlfz, Hd, Rd, Xu, Hd, Xu, Xu, Xos, Xos, Xos, Xos, Xos, Xos, Rr, Rrc, Rr, Xos, Xos, Xos, Xos, Xu, Re, Re, Hhd^Srs, 4 Hhd^Sc, Hhd^Srj, Re, Hhd, Mm^Vhh, Xu, Xos, Xos, Xos, Xos
Xos, Xos, Xu, Hd^Vda, Hd, Hd, Dd^Srot, Rd, Rd, Hd^Vda, Rd, Qlfz, Rd, Rd, Qlfz, Rd, Rd, Qlfz, Qlfz, Xu, Xu, Xos, Xos, Xos, Xos, Rr, Rrc, Rr, Xos, Xos, Xos, Xos, Xu, Hhd, Mm^Vhh, Hhd^Sro, Hhd^Srjs, Hhd^Sra, Re, Hhd, Xu, Xu, Xos, Xos, Xos, Xos
Xos, Xos, Xu, Qlfz, Qlfz, Qlfz, 5 Dd^Sct, Dd^Srst, Rd, Hd, Qlfz, Rd, Xu, Xu, Xu, Qlfz, Xu, Rd, Rd, Xu, Xu, Xos, Xos, Xos, Xos, Rr, Xu, Rr, Xos, Xos, Xos, Xos, Xu, Hhd, Hhd, Re, Re, Re, Hhd, Hhd, Xu, Xos, Xos, Xos, Xos, Xos
Xos, Xos, Xu, Hd, Qlfz, Dd^Srjl, Dd^Srgt, Dd^Srat, Rd, Qlfz, Xu, Xu, Xos, Xos, Xos, Xu, Xu, Xu, Qlfz, Rd, Xu, Xos, Xos, Xos, Xos, Xu, Xu, Xu, Xos, Xos, Xos, Xos, Xos, Xu, Xu, Re, Re, Re, Xu, Xu, Xos, Xos, Xos, Xos, Xos, Xos
Xos, Xos, Xu, Hd, Hd, Hd, Rd, Rd, Hd, Qlfz, Xu, Xos, Xos, Xos, Xos, Xos, Xos, Xu, Qlfz, Rd, Rd, Xu, Xu, Xos, Xos, Xu, Rr, Xu, Xos, Xos, Xos, Xos, Xos, Xos, Xu, Re, Hhd, Xu, Xos, Xos, Xos, Xos, Xos, Xos, Xos, Xos
Xos, Xos, Xu, Qlfz, Qlfz, Rd, Hd^Vda, Qlfz, Qlfz, Xu, Xos, Xos, Xos, Xos, Xos, Xos, Xos, Xu, Xu, Qlfz, Rd, Hd, Xu, Xos, Xos, Rr, Rr, Rr, Xos, Xos, Xos, Xos, Xos, Xos, Xu, Hhd, Re, Xu, Xos, Xos, Xos, Xos, Xos, Xos, Xos, Xos
Xos, Xos, Xos, Xu, Xu, Hd, Xu, Qlfz, Xu, Xu, Xos, Xos, Xos, Xos, Xos, Xos, Xos, Xos, Xos, Xu, Rd, Qlfz, Xu, Xos, Xos, Rr, Rr, Rr, Xos, Xos, Xos, Xos, Xos, Xos, Xos, Xu, Re, Xu, Xu, Xos, Xos, Xos, Xos, Xos, Xos, Xos
Xos, Xos, Xos, Xos, Xos, Xu, Xu, Xu, Xu, Xos, Xos, Xos, Xos, Xos, Xos, Xos, Xos, Xos, Xol, Xu, Rr, Qlfz, Xu, Xol, Xol, Rr, Rr, Rr, Xos, Xos, Xos, Xos, Xos, Xos, Xos, Xu, Re, Re, Xu, Xos, Xos, Xos, Xos, Xos, Xos, Xos
Xos, Xos, Xos, Xos, Xos, Xu, Qxu, Qxu, Qxu, Xu, Xu, Xu, Xu, Xos, Xos, Xos, Xol, Xol, Rr, Rr, Rr, Rr, Rr, Rr, Rr, Rr, Rr, Rr, Xos, Xos, Xos, Xos, Xos, Xos, Xu, Xu, Re, Hhd, Xu, Xos, Xos, Xos, Xos, Xos, Xos, Xos
Xos, Xos, Xos, Xos, Xu, Xu, Ur, Ur, Ur, Ur, Ur, Qxu, Qxu, Xu, Xos, Xos, Xu, Rr, Rr, Rr, Rr^Vct, Rr, Rr, Rr, Rr, Rr, Rr, Rr, Xos, Xos, Xos, Xos, Xu, Xu, Hhd, Re, Hhd, Hhd, Xu, Xos, Xos, Xos, Xos, Xos, Xos, Xos
Xos, Xos, Xu, Xu, Qxu, Qxu, Ur, Xu, Xu, Qxu, Qxu, Ur, Qxu, Xu, Xu, Xu, Qxu, Rr, Rr, Rr, Rr^Sro, Rr^Srat, Rr^Srs, Rr, Rr, Rr, Rr, Rr, Xos, Xos, Xu, Xu, Xu, Hhd, Re, Re, Xu, Xu, Xos, Xos, Xos, Xos, Xos, Xos, Xos, Xos
Xos, Xos, Xu, Qxu, Ur, Ur, Qxu, Xu, Xos, Xu, Qxu, Ur, Ur, Xu, Xu, Qxu, Ur, Rr, Rr, Rr, Rr^Srjt, 2 Rr^Sc, Rr^Srgt, Rr^Vct, Rr^Ii, Rr, Rr^Vct, Rr, Rr, Xu, Hhd, Re, Re, Hhd, Xu, Xu, Xos, Xos, Xos, Xos, Xos, Xos, Xos, Xos, Xos, Xos
Xos, Xos, Xu, Ur, Ur, Qxu, Xu, Xu, Xos, Xu, Xu, Ur, Qxu, Ur, Ur, Ur, Ur, Rr, Rr, Rr, Rr, Rr^Srjs, Rr^Ii, Rr^Ii, Ce, Ce, Ce, Rr, Rr, Rr, Hhd, Re, Xu, Xu, Xos, Xos, Xos, Xos, Xos, Xos, Xos, Xos, Xos, Xos, Xos, Xos
Xos, Xu, Xu, Qxu, Ur, Qxu, Xu, Xos, Xos, Xos, Xos, Xu, Xu, Qxu, Xu, Qxu, Qxu, Qxu, Rr, Rr, Rr, Rr^Vct, Rr, Rr^Ii, Ce, 1 Ke, Ce, Rr, Rr, Rr, Xu, Xu, Xos, Xos, Xos, Xos, Xos, Xos, Xu, Xos, Xos, Xos, Xos, Xos, Xos, Xos
Xos, Xu, Wwf, Qxu, Ur, Xu, Xol, Xol, Cud, Xol, Xol, Xos, Xos, Xu, Xos, Xu, Rr, Rr, Rr, Rr, Rr, Rr, Rr, Rr^Vct, Rr, Ce, Rr, Rr^Vct, Rr, Rr, Xos, Xos, Xos, Xos, Xos, Xos, Xu, Xu, Ww, Xu, Xu, Xos, Xos, Xos, Xos, Xos
Xos, Xu, Qxu, Qxu, Ur, Xu, Xol, Cud, Iwr, Cud, Cud, Xos, Xos, Xos, Rr, Rr, Rr, Rr, Xos, Xos, Rr, Rr, Rr, Rr, Rr, Rr, Rr, Rr, Xos, Xos, Xos, Xos, Xos, Xos, Xu, Xu, Wwf, Ww, Wwf, Ww, Wwf, Xu, Xu, Xos, Xos, Xos
Xos, Xu, Ur, Ur, Xos, Xol, Iwr, Iwr, Iwr, Iwr, Iwr, Xos, Xu, Xu, Xu, Rr, Xos, Xos, Cud, Xos, Xos, Rr, Rr, Rr, Xu, Rr, Xu, Xos, Xos, Xos, Xos, Xos, Xos, Xu, Ww^Vhs, Ww, Wwf^Sra, Ww, Wwf^Srs, Ww, Ww^Vhs, Wwf, Xu, Xos, Xos, Xos
Xos, Xu, Ur, Qxu, Xos, Cud, Iwr, Iwr, Kh^Ii, Iwr, Iwr, Iwr, Iwr, Xu, Xos, Xos, Iwr, Iwr, Iwr, Cud, Xos, Rr, Wwf, Xu, Wwf, Xu, Ww, Xu, Xu, Xu, Xu, Xos, Xu, Xu, Wwf, Ww, Ww, 6 Wwf^Sc, Wwf^Srg, Ww, Ww, Wwf, Xu, Xos, Xos, Xos
Xos, Xu, Ur, Qxu, Xos, Cud, Iwr, Iwr, Iwr, Iwr, Iwr, Iwr, Iwr, Xos, Iwr, Cud, Iwr, Cud, Xos, Xos, Xos, Xu, Wwf, Wwf, Ww, Wwf, Wwf, Wwf, Wwf, Ww, Ww, Xu, Wwf, Wwf, Ww, Wwf, Wwf, Wwf^Sro, Ww, Wwf, Ww, Xu, Xos, Xos, Xos, Xos
Xos, Xu, Qxu, Ur, Xos, Iwr, Iwr, Iwr, Cud, Cud, Iwr, Iwr, Iwr, Iwr, Uu^Ii, Iwr, Xos, Xos, Xol, Xos, Xos, Xu, Xu, Ww, Xu, Ww, Xu, Xu, Xu, Wwf, Wwf, Ww, Wwf, Ww, Xu, Ww, Wwf, Ww, Xu, Ww^Vhs, Xu, Xu, Xos, Xos, Xos, Xos
Xos, Xu, Qxu, Ur, Xol, Cud, Cud, Iwr, Iwr, Iwr, Cud, Cud, Iwr, Iwr, Iwr, Iwr, Iwr, Cud, Cud, Xol, Xol, Xos, Xos, Xu, Xu, Xu, Qxu, Xu, Xu, Xu, Xu, Wwf, Xu, Xu, Xos, Xu, Xu, Xu, Xos, Xu, Xos, Xos, Xos, Xos, Xos, Xos
Xos, Xu, Qxu, Ur, Ur, Xol, Xos, Cud, Iwr, Iwr, Iwr, Iwr, Cud, Cud, Iwr, Iwr, Iwr, Iwr, Iwr, Cud, Cud, Xol, Xol, Xu, Qxu, Qxu, Ur, Qxu, Qxu, Xu, Xu, Xu, Xos, Xos, Xos, Xos, Xos, Xos, Xos, Xos, Xos, Xos, Xos, Xos, Xos, Xos
Xos, Xu, Xu, Ur, Ur, Xu, Xu, Xos, Xos, Iwr, Iwr, Iwr, Iwr, Iwr, Iwr, Urb^Ii, Iwr, Iwr, Iwr, Iwr, Iwr, Cud, Xos, Xu, Qxu, Ur^Vu, Qxu, Ur, Ur, Qxu, Qxu, Xu, Xu, Xos, Xos, Xos, Xos, Xos, Xos, Xos, Xos, Xos, Xos, Xos, Xos, Xos
Xos, Xos, Xu, Ur, Ur, Qxu, Qxu, Xu, Xos, Cud, Cud, Iwr, Iwr, Iwr, Iwr, Iwr, Cud, Cud, Iwr, Iwr, Iwr^Srgt, Xos, Qxu, Qxu, Qxu, Qxu, Urb^Srst, Uh, Ur, Qxu, Ur^Vu, Qxu, Xu, Xos, Xos, Xos, Xos, Xos, Xos, Xos, Xos, Xos, Xos, Xos, Xos, Xos
Xos, Xos, Xos, Xu, Xu, Ur, Ur, Qxu, Xu, Xos, Xos, Cud, Cud, Iwr, Iwr, Iwr, Iwr, Iwr, Iwr^Srgt, 7 Kud, Iwr^Srs, Xos, Qxu, Ur^Vu, Qxu, Urb^Srat, 3 Urb^Sct, Uh, Uh, Qxu, Ur, Qxu, Xu, Xos, Xos, Xos, Xos, Xos, Xos, Xos, Xos, Xos, Xos, Xos, Xos, Xos
Xos, Xos, Xos, Xos, Xos, Xu, Ur, Ur, Ur, Xu, Xu, Xol, Xol, Cud, Cud, Iwr, Xol, Xos, Xol, Iwr^Srjs, Xol, Xos, Qxu, Ur, Qxu, Urb^Srot, Urb^Srjt, Urb^Srat, Qxu, Ur, Qxu, Qxu, Xu, Xos, Xos, Xos, Xos, Xos, Xos, Xos, Xos, Xos, Xos, Xos, Xos, Xos
Xos, Xos, Xos, Xos, Xos, Xu, Xu, Qxu, Qxu, Ur, Ur, Qxu, Qxu, Xol, Xol, Xol, Qxu, Qxu, Qxu, Xol, Ur, Xu, Ur, Ur, Ur, Ur, Ur, Ur, Qxu, Qxu, Xu, Xu, Xos, Xos, Xos, Xos, Xos, Xos, Xos, Xos, Xos, Xos, Xos, Xos, Xos, Xos
Xos, Xos, Xos, Xos, Xos, Xos, Xos, Xu, Xu, Qxu, Xu, Ur, Ur, Ur, Ur, Ur, Ur, Ur, Ur, Ur, Qxu, Ur, Qxu, Ur, Qxu, Qxu, Qxu, Qxu, Xu, Xu, Xos, Xos, Xos, Xos, Xos, Xos, Xos, Xos, Xos, Xos, Xos, Xos, Xos, Xos, Xos, Xos
Xos, Xos, Xos, Xos, Xos, Xos, Xos, Xos, Xos, Xu, Xos, Xu, Xu, Qxu, Qxu, Qxu, Xu, Xu, Xu, Xu, Xu, Qxu, Xu, Qxu, Xu, Xu, Xu, Xu, Xos, Xos, Xos, Xos, Xos, Xos, Xos, Xos, Xos, Xos, Xos, Xos, Xos, Xos, Xos, Xos, Xos, Xos
Xos, Xos, Xos, Xos, Xos, Xos, Xos, Xos, Xos, Xos, Xos, Xos, Xos, Xu, Xu, Xu, Xos, Xos, Xos, Xos, Xos, Xu, Xos, Xu, Xos, Xos, Xos, Xos, Xos, Xos, Xos, Xos, Xos, Xos, Xos, Xos, Xos, Xos, Xos, Xos, Xos, Xos, Xos, Xos, Xos, Xos
Xos, Xos, Xos, Xos, Xos, Xos, Xos, Xos, Xos, Xos, Xos, Xos, Xos, Xos, Xos, Xos, Xos, Xos, Xos, Xos, Xos, Xos, Xos, Xos, Xos, Xos, Xos, Xos, Xos, Xos, Xos, Xos, Xos, Xos, Xos, Xos, Xos, Xos, Xos, Xos, Xos, Xos, Xos, Xos, Xos, Xos
