border_size=1
usage=map

Xos, Xos, Xos, Xos, Xos, Xos, Xos, Xos, Xos, Xos, Xos, Xos, Xos, Xos, Xos, Xos, Xos, Xos, Xos, Xos, Xos, Xos, Xos
Xos, Xos, Xos, Xos, Xos, Xos, Xos, Xos, Xos, Xos, Xol, Xos, Xol, Xos, Xos, Xos, Xos, Xos, Xos, Xos, Xos, Xos, Xos
Xos, Xos, Xol, Xol, Urb, Xol, Xol, Xol, Cud, Xol, Cud, Cud, Cud, Xol, Cud, Xol, Xol, Xol, Urb, Xol, Xol, Xos, Xos
Xos, Xos, Urb, Urb, Mm, Urb, Urb, Cud, Urb, Urb, Ycp, 3 Kud^Ii, Ycp, Urb, Urb, Cud, Urb, Urb, Ww, Urb, Urb, Xos, Xos
Xos, Xos, Urb, Mm, Hh^Ii, Mm, Urb, Urb, Xos, Urb, Ycp, Ycp, Ycp, Urb, Xos, Urb, Urb, Ww, Wwr^Ii, Ww, Urb, Xos, Xos
Xos, Xos, Urb, Mm, Mm, Mm, Urb, Xos, Xol, Xol, Ycp, Ycp, Ycp, Xol, Xol, Xos, Urb, Ww, Ww, Ww, Urb, Xos, Xos
Xos, Xos, Xol, Urb, Urb, Urb, Urb, Urb, Urb, Urb, Ycp, Ycp, Ycp, Urb, Urb, Urb, Urb, Urb, Urb, Urb, Xos, Xos, Xos
Xos, Xos, Urb, Urb, Qlf, Urb, Urb, Urb, Urb, Urb, Ycp, Ycp, Ycp, Urb, Urb, Urb, Urb, Urb, Qxu, Urb, Urb, Xos, Xos
Xos, Xos, Urb, Qlf, Uh^Ii, Qlf, Urb, Urb, Xos, Xos, Ycp, Ycp, Ycp, Xos, Xos, Urb, Urb, Qxu, Rd^Ii, Qxu, Urb, Xos, Xos
Xos, Xos, Xos, Qlf, Qlf, Qlf, Xos, Xos, Xos, Xos, Ycp, 2 Ycp, Ycp, Xos, Xos, Xos, Xos, Qxu, Qxu, Qxu, Xos, Xos, Xos
Xos, Xos, Xos, Xos, Xos, Xos, Xos, Xos, Xos, Xos, Ycp, 1 Ycp, Ycp, Xos, Xos, Xos, Xos, Xos, Xos, Xos, Xos, Xos, Xos
Xos, Xos, Xos, Xos, Xos, Xos, Xos, Xos, Xos, Xos, Ycp, Ycp, Ycp, Xos, Xos, Xos, Xos, Xos, Xos, Xos, Xos, Xos, Xos
