border_size=1
usage=map

Dd, Dd, Dd^Edp, Dd, Dd, Dd, Dd, Dd, Dd, Dd, Dd^Edp, Dd, Dd, Dd, Dd, Ds, Dd, Dd, Dd^Edp, Dd, Dd, Dd^Edpp, Dd^Edpp, Dd, Dd^Edp, Dd, Dd, Ds, Ww, Wo, Wo, Ww, Ww, Ds, Dd, Dd^Edp, Dd, Dd^Edp, Ds, Dd, Dd, Dd, Dd, Dd, Dd, Dd^Edp, Dd^Edp, Dd, Dd, Dd
Dd, Dd, Dd, Dd, Dd^Edp, Dd, Dd, Dd, Dd, Dd, Dd, Dd, Dd, Dd, Dd, Dd, Dd, Dd, Dd, Dd, Dd, Ds, Dd, Dd, Dd, Dd, Ds, Dd, Dd, Ww, Ww, Wo, Ww, Dd, Dd, Dd^Edpp, Ds, Dd, Dd^Edpp, Dd, Dd^Edpp, Dd, Dd, Dd, Dd, Dd, Dd, Dd, Dd, Dd^Edp
Dd, Dd, Dd, Dd, Ds, Dd^Edpp, Dd, Dd, Dd, Dd, Dd^Edp, Dd, Dd, Dd, Dd, Dd^Edp, Dd, Dd, Dd, Dd, Dd, Dd, Ds, Dd, Dd, Dd, Dd, Dd, Dd, Dd^Edp, Ww, Wo, Ww, Dd, Dd, Dd, Dd, Dd, Dd, Dd, Dd, Dd, Dd, Dd, Ds, Dd, Dd, Dd, Dd^Edp, Dd
Dd, Dd, Dd, Dd, Ds, Dd, Dd, Dd, Dd, Ds, Ds, Dd, Dd, Dd, Dd, Dd, Hd, Hd, Hd, Dd, Dd, Dd^Edpp, Dd, Dd, Dd, Dd, Ds, Dd, Dd, Dd, Dd, Ww, Ww, Ww, Dd, Dd, Dd, Dd, Dd, Dd, Dd^Edpp, Dd^Edp, Dd, Dd, Ds^Esd, Dd, Dd, Dd, Dd^Edpp, Dd
Dd, Dd, Dd, Dd, Dd^Edpp, Dd, Dd, Dd^Edpp, Dd, Dd, Dd, Dd, Hd, Hd, Gs, Hd, Gs^Ft, Gs^Ft, Gs^Ft, Gs, Gs^Ft, Dd, Hd, Hd, Hd, Dd, Dd, Dd, Dd, Dd, Dd, Dd, Ww, Ww, Dd, Dd, Dd, Dd, Dd, Dd, Dd^Esd, Dd, Dd^Esd, Dd^Esd, Dd, Ds, Ds, Dd, Dd, Dd
Dd, Ds, Dd, Dd, Ds, Dd, Dd, Dd, Dd, Dd, Dd, Dd, Hd, Gs, Rr^Vd, Gs^Ft, Gs, Gs^Ft, Gs, Gs, Rr^Vd, Gs^Ft, Gs^Ft, Gs^Ft, Gs, Dd, Dd, Dd, Dd, Dd, Dd, Dd, Ww, Ww, Ww, Dd, Dd, Dd, Dd, Dd, Ds^Esd, Ds^Esd, Dd, Ds, Ds^Esd, Dd^Esd, Dd, Dd^Edp, Dd, Dd
Dd, Dd^Edpp, Dd, Dd^Edp, Dd, Dd, Dd, Ds, Dd^Edpp, Dd, Dd, Ds, Hd, Gs^Ft, Gs, Gs, Gs^Ft, Cdr, Cdr, Gs^Ft, Gs^Ft, Gs, Cdr, Gs, Gs^Ft, Gs, Gs, Dd, Dd, Dd, Dd, Dd, Dd, Ww, Ww, Ds, Dd, Dd^Edpp, Dd^Edpp, Dd^Edp, Dd, Dd, Ds^Esd, Dd^Esd, Dd^Esd, Ds^Esd, Ds, Ds, Dd, Dd
Ds, Dd, Dd, Dd^Edp, Dd, Dd, Dd, Dd, Dd, Dd, Dd, Dd, Gs^Ft, Gs^Ft, Gs, Gs^Ft, Gs, Gs^Ft, Gs, Gs^Ft, Gs^Ft, Cdr, Gs^Ft, Cdr, Gs, Gs^Ft, Gs, Gs^Ft, Gs^Ft, Dd, Dd, Dd, Dd, Ww, Wo, Ww, Ww, Dd, Dd, Dd, Dd^Edp, Dd^Esd, Dd^Esd, Ds, Dd, Rd^Esd, Dd^Esd, Dd^Esd, Ds^Esd, Dd
Dd, Dd, Dd, Dd, Dd, Dd^Edp, Dd, Dd, Hd, Hd, Gs, Gs^Ft, Gs, Gs, Gs^Ft, Cdr, Gs^Ft, Gs, Gs^Ft, Gs, Hhd, Gs, Gs, Gs^Ft, Rr^Vd, Gs^Ft, Gs, Gs^Ft, Gs^Ft, Hd, Ds, Dd, Dd, Ww, Ww, Wo, Ww, Dd, Dd^Edp, Dd, Dd, Dd, Dd, Dd, Dd, Ds, Dd^Esd, Dd^Esd, Dd, Ds
Dd, Dd, Dd, Dd, Dd, Dd^Edpp, Dd, Dd, Hd, Gs, Gs^Ft, Gs, Gs^Ft, Cdr, Cdr, Gs^Ft, Rd, Gs^Ft, Hhd, Hhd, Gs^Ft, Hhd, Hhd, Gs^Ft, Gs, Cdr, Cdr, Gs^Ft, Hd, Hd, Dd, Dd, Dd, Dd, Ww, Wo, Wo, Ww, Dd, Dd, Dd, Ds, Dd, Ds, Dd, Dd^Esd, Dd, Dd^Edpp, Dd, Ds
Dd, Dd, Dd, Dd, Dd, Dd, Dd, Dd, Ds, Gs, Gs, Gs^Ft, Cdr, Cdr, Gs^Ft, Rd, Gs^Ft, Hhd, Rd, Gs^Ft, Rp^Cov, Gs^Ft, Gs^Ft, Hhd, Gs^Ft, Gs^Ft, Gs^Ft, Gs, Gs^Ft, Dd, Dd, Dd^Edp, Dd, Dd, Dd, Ww, Ww, Ww, Dd, Dd, Ds, Dd, Dd, Dd, Dd, Dd, Dd, Dd, Ds, Dd
Dd, Dd, Dd, Dd, Dd, Dd, Dd, Dd, Dd^Edpp, Gs^Ft, Gs, Gs, Gs^Ft, Gs, Gs^Ft, Gs^Ft, Gs^Ft, Hhd, Gs^Ft, Rp^Cov, 3 Rrc^Kov, Rp^Cov, Rd, Hhd, Hhd, Rd, Cdr, Gs, Gs^Ft, Dd, Dd, Ds, Dd, Dd, Dd, Dd, Ww, Ww, Ww, Dd, Ww, Dd, Dd, Dd, Dd, Dd, Dd, Dd^Edpp, Dd, Dd
Dd, Dd, Dd, Dd^Edpp, Dd^Edpp, Dd, Hd, Hd, Gs^Ft, Gs^Ft, Gs, Gs^Ft, Cdr, Gs, Rr^Vd, Gs, Gs, Hhd, Gs^Ft, Rp^Cov, Rp^Cov, Rp^Cov, Gs^Ft, Gs^Ft, Hhd, Gs^Ft, Cdr, Gs, Gs^Ft, Hd, Hd, Dd^Edp, Dd, Dd, Ds, Ds, Dd, Ww, Ww, Ww, Wo, Ww, Ww, Ds, Dd, Dd, Dd, Dd, Dd, Dd
Ds, Dd^Edpp, Dd, Dd, Dd^Edp, Dd, Hd, Gs^Ft, Gs, Gs, Gs, Gs^Ft, Cdr, Gs^Ft, Gs, Gs^Ft, Gs^Ft, Hhd, Hhd, Hhd, Mv, Hhd, Hhd, Hhd, Gs^Ft, Gs^Ft, Gs, Gs, Gs, Gs^Ft, Hd, Dd, Dd, Dd, Dd^Edpp, Dd, Dd, Dd, Dd, Ww, Ww, Wo, Wo, Ww, Ww, Dd, Dd, Dd, Dd, Dd
Dd^Edpp, Ds, Dd, Dd, Ds, Dd, Dd, Gs^Ft, Gs, Gs^Ft, Gs^Ft, Gs, Gs^Ft, Gs^Ft, Gs^Ft, Gs, Gs^Ft, Rd, Hhd, Md, Md, Md, Hhd, Rd, Cdr, Rr^Vd, Gs^Ft, Gs^Ft, Gs, Gs^Ft, Dd, Ds, Ds, Dd, Dd, Dd, Dd, Dd, Dd, Dd, Dd, Ww, Ww, Wo, Wo, Ww, Ww, Ww, Ww, Ds
Dd, Dd, Dd, Dd^Edp, Dd, Ds, Dd, Gs^Ft, Gs^Ft, Rr^Vd, Gs^Ft, Gs, Gs, Gs^Ft, Cdr, Rd, Rd, Rd, Gs^Ft, Hhd, Hhd, Hhd, Rd, Gs^Ft, Gs^Ft, Cdr, Gs^Ft, Gs, Gs^Ft, Gs, Dd, Dd^Edp, Dd, Dd, Ds, Dd, Dd, Dd, Dd, Dd, Dd, Dd, Dd, Ww, Ww, Wo, Ww, Wo, Wo, Ww
Dd, Dd, Dd, Dd, Dd, Dd^Edp, Dd, Hd, Gs^Ft, Gs, Gs, Gs, Gs^Ft, Cdr, Cdr, Gs^Ft, Gs^Ft, Gs^Ft, Rr^Vd, Gs^Ft, Gs, Gs^Ft, Cdr, Gs, Gs, Gs, Gs, Gs, Gs^Ft, Gs^Ft, Dd, Dd, Dd^Edp, Hd, Gs, Hd, Hd, Dd, Dd, Dd, Dd, Dd, Dd, Dd, Dd, Ww, Dd, Ww, Ww, Ww
Dd, Dd^Edp, Dd, Dd, Dd, Dd, Dd, Hd, Hd, Gs, Gs, Gs^Ft, Gs, Gs^Ft, Gs^Ft, Gs, Gs^Ft, Gs, Gs^Ft, Gs, Gs^Ft, Gs^Ft, Cdr, Gs^Ft, Gs, Gs^Ft, Gs, Rr^Vd, Gs^Ft, Hd, Dd, Dd^Edpp, Dd^Edpp, Hd, Hd, Gs, Hd, Ds, Dd, Dd^Edp, Ds, Dd, Dd, Dd, Dd, Dd^Edp, Dd, Dd, Dd, Dd^Edpp
Dd, Dd, Dd, Dd, Ds, Dd, Dd^Edpp, Dd, Dd, Dd^Edp, Gs^Ft, Gs, Gs^Ft, Gs, Gs, Cdr, Cdr, Cdr, Gs^Ft, Cdr, Cdr, Gs, Gs, Gs^Ft, Gs^Ft, Gs, Gs^Ft, Gs^Ft, Hd, Hd, Dd, Dd, Dd, Dd, Gs^Ft, Gs^Ft, Dd, Dd, Rd, Dd, Dd, Dd, Dd^Edp, Dd, Dd, Dd, Ds, Dd, Dd, Dd
Ww, Ww, Ww, Dd, Dd, Ds, Dd, Dd^Edp, Dd, Dd^Edp, Hd, Gs^Ft, Hd, Gs, Gs^Ft, Gs^Ft, Gs, Gs^Ft, Gs, Cdr, Gs^Ft, Gs^Ft, Gs, Gs, Gs, Gs, Dd^Edpp, Dd, Dd, Dd, Dd, Dd, Dd, Hd, Rr^Vd, Gs^Ft, Dd, Rd, Dd, Dd, Dd, Dd, Dd, Dd, Dd, Dd, Dd, Dd, Dd, Dd^Edp
Wo, Wo, Wo, Ww, Ww, Dd, Ds, Dd, Dd, Dd, Ds, Hd, Dd^Edpp, Dd, Dd, Gs^Ft, Gs, Gs, Gs^Ft, Gs, Gs, Gs^Ft, Rr^Vd, Gs^Ft, Hd, Hd, Dd^Edp, Ds, Rd, Dd, Dd, Dd, Hd, Hd, Gs^Ft, Gs, Dd^Edp, Dd, Hd, Dd^Edpp, Dd, Dd, Dd^Edp, Dd, Dd, Dd, Dd, Dd^Edp, Dd, Dd
Ww, Wo, Wo, Wo, Wo, Ww, Ww, Dd^Edpp, Dd, Dd, Ds, Dd, Ds, Dd, Dd, Dd, Hd, Gs^Ft, Hd, Gs^Ft, Gs^Ft, Gs, Gs^Ft, Gs^Ft, Dd, Dd, Dd^Edp, Dd, Rd, Dd, Dd, Dd, Gs^Ft, Gs^Ft, Hd, Hd, Ds, Hd, Gs^Ft, Hd, Gs^Ft, Gs^Ft, Gs^Ft, Hd, Dd, Ds, Dd, Dd^Edp, Dd, Dd
Dd, Ww, Ww, Ww, Ww, Wo, Wo, Ww, Ww, Ww, Ww, Dd, Ds, Ds, Dd, Dd, Dd, Hd, Ds, Dd, Dd, Hd, Hd, Hd, Dd, Dd, Dd, Dd, Dd, Dd, Dd, Dd^Edpp, Ds, Hd, Dd^Edpp, Ds, Dd, Dd^Edp, Gs, Gs, Gs^Ft, Gs^Ft, Hd, Hd, Dd, Dd, Dd, Dd, Ds, Dd
Dd, Dd^Edp, Dd, Dd^Edpp, Ds, Ww, Ww, Wo, Ww, Ww, Ww, Ww, Ww, Dd, Dd, Dd, Dd, Dd, Dd, Dd, Dd, Dd, Dd, Dd, Dd, Rd, Rd, Dd, Dd, Dd, Hd, Dd, Dd, Dd, Rd, Dd, Dd, Dd, Gs^Ft, Rr^Vd, Gs, Gs^Ft, Dd, Dd, Dd^Edp, Dd, Dd, Dd^Edp, Dd, Dd
Dd, Dd, Dd, Dd^Edpp, Dd, Dd, Ds, Ww, Dd, Dd, Dd, Ww, Ww, Ww, Ww, Dd, Dd, Dd, Dd, Dd, Dd, Dd, Dd^Edpp, Dd, Dd, Dd, Dd^Edp, Dd, Dd, Hd, Gs^Ft, Hd, Dd, Rd, Ds, Dd, Dd, Dd, Gs^Ft, Gs^Ft, Dd, Dd, Dd, Dd^Edpp, Dd^Edp, Dd, Dd, Dd, Dd, Dd
Dd, Dd, Dd, Dd, Dd, Dd, Dd, Dd, Ds, Dd, Dd, Dd, Ww, Wo, Wo, Ww, Ww, Dd^Edpp, Dd, Dd, Dd^Edpp, Dd, Dd, Ds, Dd, Dd, Hd, Hd, Gs^Ft, Gs, Rr^Vd, Gs^Ft, Gs^Ft, Dd, Hd, Hd, Gs^Ft, Gs, Gs, Hd, Dd, Dd, Ds, Dd^Edpp, Dd, Dd, Dd, Ds, Dd, Dd
Dd, Ds, Dd, Dd, Hd, Dd, Dd, Dd, Dd, Dd, Dd, Dd, Ds, Ww, Ww, Wo, Wo, Ww, Ds, Dd, Dd, Dd^Edpp, Ds, Dd, Ds, Dd, Hd, Gs^Ft, Dd, Hd, Hd, Hd, Dd, Dd, Hd, Gs^Ft, Rr^Vd, Gs^Ft, Hd, Hd, Dd, Dd, Dd, Ds, Ds, Dd, Dd, Dd, Dd, Dd
Ds, Dd, Dd, Hd, Dd, Hd, Hd, Dd, Dd, Ds, Dd^Edpp, Ds, Dd, Dd, Dd, Ww, Wo, Ww, Ww, Ds, Dd, Dd, Ds, Dd, Dd, Dd, Rd, Gs^Ft, Ds, Dd, Ds, Dd, Hd, Dd, Dd, Dd, Ds, Dd, Dd, Dd^Edp, Dd, Dd, Dd, Dd, Ds, Dd, Dd, Dd, Dd, Dd
Dd, Dd, Dd, Dd, Dd, Dd, Hd, Hd, Hd, Dd, Dd, Dd, Dd, Dd, Dd, Ww, Ww, Wo, Wo, Ww, Ww, Dd^Edp, Dd, Dd, Dd, Dd, Dd, Rd, Dd, Dd, Dd, Dd, Gs^Ft, Hd, Dd, Rd, Rd, Dd, Dd, Dd, Dd^Edp, Rd, Rd, Dd, Dd, Dd, Dd, Dd, Dd^Edp, Dd
Dd, Dd, Dd, Dd, Dd^Edpp, Dd, Dd, Hd, Dd, Dd, Dd^Vdt, Dd, Dd, Dd, Ds, Dd, Dd, Ww, Ww, Wo, Ww, Ww, Ww, Dd^Edpp, Ds, Dd, Dd, Dd, Gs^Ft, Dd^Edp, Gs, Gs^Ft, Gs^Ft, Hd, Dd, Dd, Dd^Edpp, Ds, Ds, Dd, Dd^Edpp, Dd^Esd, Dd, Dd^Esd, Dd, Dd, Dd, Dd, Dd, Dd
Ds, Dd, Dd, Dd, Dd, Dd, Dd, Dd, Dd, Dd, Ds, Dd, Dd, Dd, Dd, Dd^Edpp, Dd^Edpp, Dd, Dd, Ww, Dd, Ww, Ww, Ww, Ww, Dd, Hd, Gs, Gs, Gs^Ft, Gs, Gs, Rr^Vd, Gs, Gs^Ft, Dd, Dd^Edp, Dd^Edpp, Dd, Dd, Dd^Esd, Dd, Dd, Dd, Dd, Dd, Dd, Dd, Dd, Dd
Dd, Dd, Dd, Dd, Dd, Dd, Dd, Dd, Ds, Dd, Hd, Dd, Dd^Edpp, Dd, Dd, Dd, Dd, Dd, Dd, Dd, Dd, Dd, Dd, Ww, Ww, Dd^Edp, Hd, Gs^Ft, Gs^Ft, Gs, Gs, Gs^Ft, Gs, Gs, Gs^Ft, Hd, Dd, Dd^Edpp, Ds, Dd^Esd, Dd^Edpp, Dd, Dd, Dd, Dd, Dd, Dd, Dd, Dd, Dd
Dd, Dd, Dd, Dd, Ds, Dd, Dd, Dd^Edpp, Dd, Dd, Dd, Hd, Hd, Dd, Dd, Ds, Dd^Edp, Dd, Dd^Edpp, Dd^Edp, Ds, Dd, Dd, Ww, Wo, Ww, Ww, Hd, Ds, Dd, Ds, Gs, Gs^Ft, Gs^Ft, Hd, Hd, Dd, Dd, Dd^Esd, Dd^Edpp, Dd^Edpp, Dd, Dd, Dd, Dd^Edpp, Dd, Dd, Dd, Ds, Ds
Dd, Ds, Dd, Dd, Dd, Hd, Hd, Hd, Dd^Edpp, Dd, Dd^Esd, Dd, Hd, Hd, Hd, Dd, Dd, Dd, Dd, Dd, Ds^Esd, Ds, Dd, Ww, Ww, Wo, Ww, Dd^Edpp, Dd, Dd, Dd, Dd, Dd^Edpp, Dd, Dd, Dd, Dd, Rd, Rd, Dd, Dd^Esd, Ds, Dd^Esd, Rd, Dd, Dd, Dd, Dd, Dd, Dd
Dd, Dd^Edpp, Dd, Dd^Vdt, Hd, Hd, Hd, Dd, Md, Dd^Edp, Dd, Dd, Dd, Hd, Dd^Edp, Dd^Edp, Ds, Hd, Hd, Dd, Ds, Dd, Dd, Ds, Ww, Wo, Wo, Ww, Dd, Dd, Dd, Dd, Ds, Dd, Dd, Rd, Dd^Esd, Dd, Dd^Esd, Dd, Dd^Edpp, Dd^Esd, Dd^Edp, Rd, Dd^Esd, Ds, Dd^Vdt, Ds, Dd^Edp, Dd^Edp
Dd, Dd^Edpp, Dd^Edpp, Dd, Dd, Hd, Hd, Md, Md, Md, Dd, Dd, Dd, Dd, Dd, Dd, Dd, Dd, Dd, Hd, Hd, Dd, Ds, Dd, Dd, Ww, Wo, Ww, Ww, Dd, Dd, Dd, Dd, Dd^Edp, Dd, Rd, Dd^Esd, Dd^Esd, Dd^Esd, Dd^Esd, Dd^Esd, Dd^Esd, Dd^Esd, Dd^Esd, Ds, Dd, Dd^Edpp, Dd^Edp, Dd, Dd
Dd, Dd, Dd, Dd, Ds, Dd, Dd^Edp, Hd, Dd, Hd, Dd, Dd, Dd, Dd^Vdt, Ds, Dd, Dd^Esd, Dd, Dd^Edp, Dd, Hd, Dd, Dd, Dd, Dd, Ww, Ww, Wo, Ww, Dd^Edpp, Dd, Dd, Dd, Dd, Dd, Dd, Dd, Dd, Rd, Rd, Dd, Dd, Dd^Edp, Dd, Dd, Dd, Ds, Ds, Dd, Dd^Edp
Dd, Dd, Dd^Edpp, Dd, Dd, Dd^Edp, Dd^Edp, Dd, Dd, Dd, Dd, Dd^Edpp, Dd, Dd, Dd, Ds, Dd, Dd, Dd, Dd, Hd, Ds, Dd, Dd, Ds, Dd^Esd, Dd, Ww, Ww, Dd, Dd, Dd, Dd, Dd, Dd, Dd, Dd, Dd, Dd, Dd, Dd, Dd, Ds, Dd, Dd^Vdt, Dd, Ds, 2 Hd, Dd, Ds
Dd^Edp, Dd, Hd, Dd, Ce, Ce, Ds, Ds, Dd, Dd^Vdt, Dd, Dd, Hd, Dd, Hd, Dd^Edp, Dd, Dd, Dd, Hd, Hd, Hd, Hd, Ds^Esd, Ds, Dd, Dd, Ww, Ww, Dd, Dd, Dd, Dd, Dd, Dd^Edpp, Dd^Edp, Dd, Ds, Dd, Dd, Dd, Dd^Vdt, Ds, Dd, Dd, Dd, Dd, Ds, Dd, Dd
Dd, Dd, Hd, Hd, Ce, 4 Ke, Ds, Dd, Dd, Dd^Edpp, Dd, Dd, Md, Hd, Hd, Hd, Dd, Dd, Dd, Dd, Dd, Hd, Dd, Dd, Dd, Ds, Dd, Ww, Ww, Ww, Ww, Dd, Dd, Ds, Dd, Dd, Dd, Dd, Dd, Ds, Dd^Vdt, Dd, Dd, Dd, Dd, Dd, Dd^Vdt, Dd, Dd, Dd
Dd, Hd, Hd, Dd, Hd, Ds, Dd, Dd, Dd, Dd^Edpp, Ds, Hd, Hd, Md, Md, Dd, Dd, Dd^Edpp, Dd^Edp, Dd, Dd, Dd, Dd, Dd, Ds, Dd, Dd, Dd, Dd, Ww, Wo, Ww, Dd, Dd, Dd, Dd, Dd, Ds, Dd, Dd, Dd, Dd^Edp, Ce, Ce, Ce, Dd, Ds, Dd^Edpp, Ds, Dd
Dd, Dd, Dd^Vdt, Hd, Hd, Hd, Dd, Dd, Dd^Edpp, Ds, Dd, Hd, Hd, Hd, Hd, Dd, Ds, Dd, Dd, Dd, Dd^Edpp, Dd, Hd, Dd, Hd, Dd, Dd, Dd, Dd, Ww, Wo, Ww, Dd, Dd, Dd, Dd, Dd, Dd, Dd^Edpp, Dd, Dd^Vdt, Dd, Ce, 1 Ke, Hd, Dd, Dd^Edp, Dd, Dd^Edpp, Dd
Dd, Dd, Dd, Dd, Dd^Edp, Dd^Edp, Dd^Edp, Dd, Dd, Dd, Dd, Dd, Dd, Dd^Edp, Dd, Dd, Dd^Edpp, Dd, Dd, Dd, Dd, Hd, Dd, Hd, Hd, Hd, Dd, Dd, Dd, Ww, Wo, Ww, Dd^Edpp, Dd, Dd, Dd, Dd, Dd, Dd^Edp, Ds, Dd, Dd, Dd, Hd, Ds, Dd, Dd, Dd, Dd^Edpp, Dd
Dd, Dd^Edp, Ds, Dd, Dd, Dd, Dd, Dd^Edpp, Dd, Ds, Dd, Dd, Dd, Dd^Edpp, Dd, Ds, Dd, Dd, Dd, Dd, Dd^Edp, Dd^Edpp, Dd, Dd, Dd, Dd, Dd, Dd, Dd, Ww, Wo, Ww, Dd, Dd^Edp, Dd, Ds, Dd, Dd, Dd, Dd^Edp, Dd, Dd^Edp, Dd, Dd, Ds, Dd, Dd, Dd, Dd, Dd
