border_size=1
usage=map

Xu, Xu, Xu, Xu, Xu, Xu, Xu, Xu, Xu, Xu, Xu, Xu, Xu, Xu, Xu, Xu, Xu, Xu, Xu, Xu, Qlf, Qlf, Re, Re, Re, Qlf, Xu, Xu, Xu, Xu, Xu, Xu, Xu, Xu, Xu, Xu, Xu, Xu, Xu, Xu, Xu, Gg
Xu, Xu, Xu, Xu, Xu, Xu, Xu, Xu, Xu, Xu, Xu, Xu, Xu, Xu, Xu, Xu, Xu, Xu, Xu, Xu, Qlf, Re, Re, Re, Re, Qlf, Xu, Xu, Xu, Xu, Xu, Xu, Xu, Xu, Xu, Xu, Xu, Xu, Xu, Xu, Xu, Xu
Xu, Xu, Xu, Xu, Xu, Xu, Xu, Xu, Xu, Xu, Xu, Xu, Xu, Xu, Xu, Xu, Xu, Xu, Xu, Xu, Uu^Uf, Re, Ce, Re, Re, Uu, Qlf, Xu, Xu, Xu, Xu, Xu, Xu, Xu, Xu, Xu, Xu, Xu, Xu, Xu, Xu, Xu
Xu, Xu, Xu, Xu, Xu, Xu, Xu, Xu, Xu, Xu, Qlf, Xu, Qlf, Xu, Xu, Xu, Qlf, Xu, Re, Uu^Uf, Re, Re, Ce, 1 Ke, Ce, Uu, Uu, Qlf, Re, Qlf, Qlf, Xu, Xu, Xu, Qlf, Xu, Xu, Xu, Xu, Xu, Xu, Xu
Xu, Xu, Xu, Xu, Xu, Xu, Xu, Xu, Xu, Qlf, Uu, Qlf, Re, Re, Re, Qlf, Uu^Uf, Re, Re, Re, Re, Re, Uu, Uh, Re, Re, Re, Re, Uu, Re, Uu^Uf, Uu^Uf, Uu, Re, Re, Qlf, Xu, Xu, Xu, Xu, Xu, Xu
Xu, Xu, Xu, Xu, Xu, Xu, Xu, Xu, Uu^Uf, Uu, Re, Uu, Re, Uu, Uu, Uu^Uf, Uu^Uf, Re, Uu, Uu, Re, Uu, Qlf, Xu, Xu, Re, Re, Uu, Uu^Uf, Re, Re, Uu, Re, Uu, Re, Qlf, Qlf, Xu, Xu, Xu, Xu, Xu
Xu, Xu, Xu, Xu, Xu, Xu, Qlf, Uu, Uu^Uf, Re, Uu, Uu, Re, Re, Re, Re, Re, Re, Re, Uu, Xu, Qlf, Qlf, Xu, Xu, Uu, Re, Uu, Uu, Uu^Uf, Uu, Re, Uu^Uf, Re, Re, Uu, Re, Xu, Xu, Xu, Xu, Xu
Xu, Xu, Xu, Xu, Qlf, Qlf, Qlf, Qlf, Uu, Re, Re, Re, Uu, Uu, Xu, Uu, Uu, Uu, Re, Qlf, Xu, Xu, Xu, Xu, Xu, Uu, Uu, Re, Uh, Uh, Uu, Uu, Xu, Uu^Uf, Re, Uu, Re, Xu, Xu, Xu, Xu, Xu
Xu, Xu, Xu, Xu, Qlf, Qlf, Qlf, Uu, Re, Re, Uu, Xu, Xu, Xu, Xu, Xu, Qlf, Uu, Re, Qlf, Qlf, Xu, Xu, Xu, Xu, Qlf, Re, Re, Re, Uu, Xu, Xu, Xu, Xu, Uu, Re, Uu^Uf, Xu, Xu, Xu, Xu, Xu
Xu, Xu, Xu, Xu, Uu, Uu, Uu, Re, Re, Uu, Xu, Xu, Xu, Xu, Xu, Qlf, Uu, Re, Uu, Re, Re, Xu, Xu, Qlf, Qlf, Qlf, Re, Uu, Re, Uu, Xu, Xu, Xu, Xu, Uu, Re, Uu^Uf, Xu, Xu, Xu, Xu, Xu
Xu, Xu, Xu, Xu, Qlf, Re, Uu^Uf, Re, Uu^Uf, Xu, Xu, Xu, Xu, Xu, Xu, Qlf, Re, Re, Xu, Uu, Uu, Re, Uu, Uu, Uh, Uu, Uu, Uu, Uu, Re, Xu, Xu, Qlf, Xu, Re, Uu, Re, Xu, Xu, Xu, Xu, Xu
Xu, Xu, Xu, Qlf, Qlf, Re, Re, Re, Uu, Xu, Xu, Xu, Qlf, Qlf, Uh, Uh, Re, Xu, Xu, Xu, Qlf, Re, Re, Uh, Uu, Uu^Uf, Uu^Uf, Re, Uu, Uu, Uu^Uf, Xu, Qlf, Qlf, Uu, Re, Re, Qlf, Xu, Xu, Xu, Xu
Xu, Xu, Xu, Xu, Uu, Uu^Uf, Uu^Uf, Re, Uu, Xu, Re, Xu, Qlf, Uh, Re, Re, Xu, Xu, Xu, Xu, Xu, Qlf, Uu, Re, Uu, Uu, Re, Re, Re, Re, Re, Uu^Uf, Re, Re, Uu, Re, Uh, Qlf, Xu, Xu, Xu, Xu
Xu, Xu, Xu, Xu, Uu, Re, Uu, Re, Re, Uu, Re, Uu^Uf, Uu^Uf, Uh, Re, Re, Re, Xu, Qlf, Qlf, Qlf, Qlf, Uu, Re, Re, Re, Re, Ur, Uh, Uh, Xu, Re, Re, Uu, Re, Re, Uh, Qlf, Qlf, Xu, Xu, Xu
Xu, Xu, Qlf, Uu, Re, Re, Re, Re, Uu, Re, Re, Re, Uu, Re, Uu, Uu, Re, Uu, Uh, Re, Re, Re, Uu^Uf, Uu, Re, Uu, Re, Ur, Qlf, Qlf, Xu, Xu, Xu, Re, Uu, Re, Uu, Uh, Qlf, Xu, Xu, Xu
Xu, Xu, Qlf, Qlf, Re, Uu, Xu, Uu, Xu, Uu, Uh, Re, Re, Re, Re, Uu, Uu^Uf, Uu, Uu, Uh, Xu, Ur, Ur, Uu^Uf, Re, Uu, Uu, Re, Qlf, Xu, Xu, Xu, Xu, Re, Uu, Re, Re, Uu, Xu, Xu, Xu, Xu
Xu, Xu, Xu, Qlf, Re, Re, Xu, Xu, Xu, Xu, Xu, Uh, Uu^Uf, Uu, Uu, Re, Uu^Uf, Uu^Uf, Qlf, Xu, Xu, Xu, Xu, Uu^Uf, Uu, Re, Re, Uh, Uu^Uf, Xu, Xu, Xu, Uu^Uf, Re, Re, Uu, Uh, Uu, Xu, Xu, Xu, Xu
Xu, Xu, Xu, Qlf, Re, Uu, Xu, Xu, Xu, Xu, Xu, Xu, Qlf, Re, Re, Re, Uh, Uh, Xu, Xu, Xu, Xu, Qlf, Qlf, Ur, Uu, Re, Uu^Uf, Uu, Uu, Uu, Uu, Uu, Uu^Uf, Re, Uu, Uh, Re, Xu, Xu, Xu, Xu
Xu, Xu, Qlf, Qlf, Re, Uu, Uu, Xu, Qlf, Qlf, Qlf, Qlf, Qlf, Uu, Re, Uu, Qlf, Qlf, Xu, Xu, Xu, Xu, Xu, Qlf, Ur, Uu, Uu, Re, Re, Uu, Re, Re, Re, Uu, Re, Re, Uu, Re, Xu, Xu, Xu, Xu
Xu, Xu, Xu, Qlf, Qlf, Re, Re, Uu, Uu, Qlf, Rb, Qlf, Uu, Uu, Re, Uu, Uu, Qlf, Re, Re, Ur, Xu, Uu, Qlf, Qlf, Ur, Uh, Uh, Uh, Re, Xu, Xu, Qlf, Re, Re, Uu, Ur, Xu, Xu, Xu, Xu, Xu
Xu, Xu, Xu, Qlf, Qlf, Uu, Uu, Re, Re, Re, Re, Uu, Re, Re, Ur, Uu, Uu^Uf, Re, Uu, Uu, Ur, Rb, Rb, Re, Qlf, Uu, Uu, Uu, Re, Xu, Xu, Xu, Xu, Qlf, Re, Uu, Ur, Xu, Xu, Xu, Xu, Xu
Xu, Xu, Xu, Xu, Re, Re, Uu, Re, Uu, Uu, Uu, Re, Uh, Uh, Ur, Ur, Uu^Uf, Uu^Uf, Uu, Re, Qlf, Rb, Uu, Uu^Uf, Uu^Uf, Uu^Uf, Ur, Qlf, Xu, Xu, Xu, Xu, Xu, Qlf, Re, Ur, Re, Xu, Xu, Xu, Xu, Xu
Xu, Xu, Xu, Xu, Qlf, Re, Ur, Re, Uu^Uf, Uu^Uf, Xu, Qlf, Qlf, Qlf, Xu, Uu, Uu, Ur, Uu, Qlf, Uh, Uh, Uu, Uu, Uu, Ur, Uh, Qlf, Qlf, Xu, Xu, Xu, Xu, Xu, Uu, Re, Qlf, Xu, Xu, Xu, Xu, Xu
Xu, Xu, Xu, Qlf, Uu, Uu^Uf, Ur, Re, Uu^Uf, Xu, Xu, Xu, Xu, Xu, Xu, Xu, Uu, Ur, Ur, Uu, Chr, Chr, Chr, Uh, Uu, Ur, Uu^Uf, Uu^Uf, Uu^Uf, Xu, Re, Xu, Uu^Uf, Uu^Uf, Re, Re, Qlf, Qlf, Xu, Xu, Xu, Xu
Xu, Xu, Xu, Qlf, Uu, Uu^Uf, Uh, Re, Uu, Re, Xu, Xu, Xu, Xu, Uh, Uh, Qlf, Uu^Uf, Uu, Uu, Chr, 2 Khr, Chr, Uh, Re, Qlf, Uh, Uu, Uu, Uu, Uh, Re, Uu, Uu, Re, Uu, Xu, Xu, Xu, Xu, Xu, Xu
Xu, Xu, Xu, Qlf, Re, Uu, Uh, Re, Uu, Re, Xu, Qlf, Qlf, Xu, Ur, Qlf, Qlf, Uu^Uf, Uu^Uf, Uh, Ur, Chr, Ur, Ur, Qlf, Qlf, Uh, Ur, Uu, Uu, Uu, Uh, Uu, Re, Uu, Uu, Xu, Xu, Xu, Xu, Xu, Xu
Xu, Xu, Xu, Xu, Re, Uh, Uu, Re, Re, Uu, Re, Qlf, Re, Ur, Uu, Ur, Uh, Uu, Uu, Uh, Uu, Ur, Uu, Ur, Ur, Uu, Re, Ur, Re, Uu, Re, Uh, Re, Re, Re, Re, Xu, Xu, Xu, Xu, Xu, Xu
Xu, Xu, Xu, Xu, Uu, Re, Re, Re, Uu, Re, Re, Re, Re, Uu, Re, Uu, Uh, Re, Uu, Qlf, Qlf, Uu, Re, Xu, Xu, Uu, Re, Ur, Uu, Re, Uu, Re, Uu, Re, Re, Re, Xu, Xu, Xu, Xu, Xu, Xu
Xu, Xu, Xu, Xu, Qlf, Uu, Re, Uu, Uu, Uu, Uh, Re, Uu^Uf, Re, Uu^Uf, Re, Re, Re, Re, Qlf, Uu, Re, Uu^Uf, Xu, Ur, Re, Ur, Uu, Re, Uu, Re, Re, Uu^Uf, Uu, Re, Uu, Qlf, Xu, Xu, Xu, Xu, Xu
Xu, Xu, Xu, Qlf, Qlf, Uu, Uu^Uf, Re, Ur, Ur, Xu, Uh, Re, Uu^Uf, Re, Uh, Re, Ur, Uh, Ur, Uu, Uu^Uf, Uu, Uu, Uu, Uh, Uh, Uu, Re, Uu, Re, Uu^Uf, Xu, Uu, Re, Uu, Qlf, Xu, Xu, Xu, Xu, Xu
Xu, Xu, Xu, Xu, Qlf, Re, Re, Re, Uu, Xu, Xu, Qlf, Qlf, Re, Uu, Uh, Re, Uu, Uu, Uh, Ur, Uu^Uf, Xu, Qlf, Qlf, Re, Uh, Re, Uu, Uu, Xu, Xu, Xu, Xu, Xu, Re, Uu, Qlf, Xu, Xu, Xu, Xu
Xu, Xu, Xu, Xu, Xu, Qlf, Re, Uu, Re, Xu, Xu, Qlf, Xu, Xu, Uu, Ur, Uh, Re, Uu, Uh, Xu, Xu, Xu, Qlf, Xu, Re, Ur, Re, Uu^Uf, Xu, Xu, Xu, Xu, Xu, Xu, Re, Re, Uu, Xu, Xu, Xu, Xu
Xu, Xu, Xu, Xu, Xu, Xu, Uh, Re, Uu, Re, Uu^Uf, Xu, Uh, Uu, Ur, Ur, Re, Re, Re, Xu, Xu, Xu, Xu, Xu, Xu, Xu, Ur, Re, Re, Xu, Xu, Xu, Qlf, Qlf, Uu, Re, Uu, Uu, Xu, Xu, Xu, Xu
Xu, Xu, Xu, Xu, Xu, Xu, Uh, Re, Re, Uu, Ur, Uu^Uf, Re, Uh, Qlf, Re, Re, Uu, Re, Xu, Qlf, Qlf, Xu, Xu, Xu, Uu^Uf, Uu^Uf, Re, Uu, Xu, Xu, Xu, Qlf, Uu, Re, Re, Re, Uu, Xu, Xu, Xu, Xu
Xu, Xu, Xu, Xu, Xu, Xu, Uu, Uh, Re, Uu, Ur, Re, Xu, Xu, Qlf, Qlf, Xu, Uu, Uu, Re, Re, Qlf, Uh, Uu, Uu, Re, Uu, Uu, Re, Re, Re, Qlf, Re, Re, Uu^Uf, Uu^Uf, Xu, Xu, Xu, Xu, Xu, Xu
Xu, Xu, Xu, Xu, Xu, Xu, Uu, Re, Uu, Re, Re, Re, Uh, Xu, Xu, Xu, Xu, Xu, Uu^Uf, Re, Uu, Uu^Uf, Uu^Uf, Uh, Re, Re, Re, Uu, Uu, Re, Uu, Re, Re, Re, Qlf, Xu, Xu, Xu, Xu, Xu, Xu, Xu
Xu, Xu, Xu, Xu, Xu, Xu, Xu, Uu, Re, Uu, Re, Uu, Uu, Uh, Uu^Uf, Re, Re, Uu, Re, Uu, Re, Re, Rb, Rb, Uu, Uu, Qlf, Re, Qlf, Uu, Xu, Xu, Xu, Qlf, Xu, Xu, Xu, Xu, Xu, Xu, Xu, Xu
Xu, Xu, Xu, Xu, Xu, Xu, Xu, Xu, Xu, Qlf, Qlf, Re, Re, Re, Re, Uu^Uf, Re, Re, Uu, Uu, Qlf, Rb, Rb, Qlf, Qlf, Qlf, Qlf, Qlf, Xu, Xu, Xu, Xu, Xu, Xu, Xu, Xu, Xu, Xu, Xu, Xu, Xu, Xu
Xu, Xu, Xu, Xu, Xu, Xu, Xu, Xu, Xu, Qlf, Xu, Qlf, Qlf, Uu, Uu, Re, Xu, Qlf, Qlf, Qlf, Xu, Rb, Xu, Xu, Xu, Xu, Xu, Xu, Xu, Xu, Xu, Xu, Xu, Xu, Xu, Xu, Xu, Xu, Xu, Xu, Xu, Xu
Xu, Xu, Xu, Xu, Xu, Xu, Xu, Xu, Xu, Xu, Xu, Xu, Xu, Xu, Xu, Xu, Xu, Xu, Xu, Xu, Qlf, Xu, Urb, Qlf, Qlf, Xu, Xu, Xu, Xu, Xu, Xu, Xu, Xu, Xu, Xu, Xu, Xu, Xu, Xu, Xu, Xu, Xu
Xu, Xu, Xu, Xu, Xu, Xu, Xu, Xu, Xu, Xu, Xu, Xu, Xu, Xu, Xu, Xu, Xu, Xu, Xu, Qlf, Uu, Urb, Urb, Uu, Urb, Xu, Xu, Xu, Xu, Xu, Xu, Xu, Xu, Xu, Xu, Xu, Xu, Xu, Xu, Xu, Xu, Xu
Xu, Xu, Xu, Xu, Xu, Xu, Xu, Xu, Xu, Xu, Xu, Xu, Xu, Xu, Xu, Xu, Xu, Xu, Xu, Urb, Urb, Uu, Urb, Uu, Uu, Xu, Xu, Xu, Xu, Xu, Xu, Xu, Xu, Xu, Xu, Xu, Xu, Xu, Xu, Xu, Xu, Xu
