border_size=1
usage=map

Xu, Rb, Rb, Uu, Uu, Uu, Rb, Xu, Xu, Mm^Xm, Mm^Xm, Mm, Mm, Mm, Hh, Mm, Mm, Mm^Xm, Mm, Mm, Mm, Mm, Hh, Hh, Ds, Ss, Gs, Gs, Gs, Gs, Ds, Gs, Ss, Ss, Ds, Ww, Wo, Wo, Wo, Wo, Wo, Wo, Wo, Wo, Wo, Wo
Xu, Rb, Rb, Rb, Uu, Uu, Uu, Rb, Xu, Xu, Mm^Xm, Mm, Mm, Mm, Mm, Hh, Mm, Mm, Mm, Mm, Hh, Hh, Ds, Ds, Ss, Ds, Ss, Ss, Gs, Gs, Ds, Gs, Ss, Ss, Ds, Ww, Wo, Wo, Wo, Wo, Wo, Wo, Wo, Wo, Wo, Wo
Xu, Xu, Rb, Uu, Uu, Uu, Uu, Rb, Xu, Xu, Mm^Xm, Mm^Xm, Mm, Mm, Hh, Hh, Hh, Hh, Hh, Hh, Hh, Hh, Gs, Gg, Gg, Ds, Gs, Ss, Ds, Ss, Ds, Gs, Gs, Gs, Ww, Ww, Wo, Wo, Wo, Wo, Wo, Wo, Wo, Wo, Wo, Wo
Mm^Xm, Xu, Xu, Rb, Xu, Uu, Uu, Uu, Uu, Xu, Xu, Mm^Xm, Mm, Hh, Mm^Xm, Mm^Xm, Hh, Hh, Gg, Gs, Gs, Gs, Gs, Gll^Fp, Gll^Fp, Gg, Gs, Gs, Gs, Ds, Gs, Gs, Ss, Ds, Ww, Wo, Wo, Wo, Wo, Wo, Wo, Wo, Wo, Wo, Wo, Wo
Mm^Xm, Mm^Xm, Mm^Xm, Xu, Xu, Xu, Rb, Rb, Uu, Uu, Xu, Mm^Xm, Gg, Hh, Hh, Mm^Xm, Re^Vct, Gg, Gll^Fp, Gs, Gg, Gs, Gll^Fp, Gg, Gs, Gs, Gg, Gll^Fp, Gll^Fp, Gg, Gg, Ds, Gs, Ds, Ww, Wo, Wo, Wo, Wo, Wo, Wo, Wo, Wo, Wo, Wo, Wo
Hh, Mm, Hh, Mm^Xm, Mm^Xm, Xu, Xu, Rb, Rb, Gg, Gg, Gg, Gll^Fp, Gg, Hh, Hh, Gg, Gll^Fp, Gll^Fp, Gg, Gll^Fp, Gg, Gll^Fp, Gll^Fp, Gll^Fp, Gll^Fp, Gll^Fp, Gg, Gg, Gll^Fp, Gg, Gll^Fp, Gll^Fp, Ds, Ww, Ww, Wo, Wo, Wo, Wo, Wo, Wo, Wo, Wo, Wo, Wo
Hh, Hh, Hh, Mm^Xm, Mm^Xm, Mm^Xm, Xu, Xu, Gg, Gg, Gll^Fp, Gll^Fp, Gll^Fp, Gg, Re^Vct, Gg, Ce, Gll^Fp, Re^Vct, Gg, Gll^Fp, Gg, Gll^Fp, Gll^Fp, Gg, Gll^Fp, Gll^Fp, Gs, Gll^Fp, Gll^Fp, Gll^Fp, Gg, Gg, Gg, Ds, Ww, Ww, Wo, Wo, Wo, Wo, Wo, Wo, Wo, Wo, Wo
Mm, Mm, Mm^Xm, Hh, Hh, Hh, Hh, Gg, Gg, Gg, Gg, Gg, Gg, Gg, Gll^Fp, Ce, 1 Ke, Ce, Gll^Fp, Gg, Gll^Fp, Gll^Fp, Gg, Gll^Fp, Gg, Gll^Fp, Gs, Gs, Gll^Fp, Gs, Gs, Gll^Fp, Gll^Fp, Gs, Gs, Ds, Ww, Wo, Wo, Wo, Wo, Wo, Wo, Wo, Wo, Wo
Mm, Mm, Mm, Mm, Mm, Hh, Hh, Hh, Gg, Gg, Gll^Fp, Gg, Re^Vct, Gll^Fp, Gll^Fp, Ce, Gg, Ce, Gll^Fp, Gg, Gll^Fp, Gll^Fp, Gg, Gg, Gll^Fp, Gs, Gll^Fp, Gs, Gll^Fp, Gll^Fp, Gll^Fp, Gll^Fp, Gll^Fp, Gll^Fp, Gg, Gll^Fp, Ds, Ww, Ww, Wo, Wo, Wo, Wo, Wo, Wo, Wo
Hh, Mm, Hh, Mm, Gg, Gg, Gg, Gg, Gll^Fp, Gll^Fp, Gll^Fp, Gg, Gg, Gll^Fp, Gg, Gg, Ww, Gg, Gg, Gg, Gg, Gg, Ww, Gll^Fp, Gg, Gll^Fp, Gll^Fp, Gll^Fp, Gg, Gll^Fp, Gs, Gs, Gg, Gg, Gll^Fp, Gll^Fp, Ds, Ww, Ww, Ww, Ww, Wo, Wo, Wo, Wo, Wo
Gs, Hh, Gg, Gg, Gg, Gll^Fp, Gll^Fp, Gg, Gg, Gll^Fp, Gg, Gg, Gg, Gg, Ww, Ww, Wo, Ww, Ww^Bw|r, Ww, Ww, Ww, Wo, Ww, Ww, Gs, Gs, Gs, Gll^Fp, Gs, Gs, Gs, Ww, Gll^Fp, Ds, Ds, Ww, Ww, Ww, Ww, Ww, Wo, Wo, Wo, Wo, Wo
Gg, Gs, Gll^Fp, Gll^Fp, Gll^Fp, Gs, Gg, Gg, Ww, Gg, Ww, Ww, Ww, Ww, Wo, Wo, Ww, Ww, Ww^Bw|r, Ww, Ww, Wo, Ww, Wo, Wo, Ww, Ww, Gll^Fp, Gg, Gg, Ww, Ww, Wo, Ww, Ww, Ww, Ww, Ww, Ww, Ww, Ds, Ww, Wo, Wo, Wo, Wo
Gg, Gg, Gg, Gll^Fp, Gs, Gs, Ww, Ww, Wo, Ww, Ww, Ww, Ww, Ww, Ww, Ww, Gg, Gg, Gg, Gs, Gs, Ww, Gg, Ww, Ww, Wo, Wo, Ww, Ww, Ww^Bw\r, Wo^Bw\r, Wo, Ww, Wo, Ww, Ww, Ds, Ds, Ds, Ds, Ds, Ww, Wo, Wo, Wo, Wo
Ww, Ww, Ww, Gg, Gg, Gg, Ww, Wo, Ww, Ww, Gg, Gg, Gg, Gg, Gg, Gg, Gg, Gs, Gs, Gg, Gg, Gg, Gs, Gs, Gs, Ww, Ww, Wo, Wo, Wo, Ww, Ww^Bw\r, Gg, Ww, Ds, Ds, Gg, Gs, Gs, Ds, Ds, Ww, Ww, Wo, Wo, Wo
Ww, Ww, Ww, Ww, Ww, Ww^Bw\r, Ww^Bw\r, Ww, Gg, Gg, Gg, Gd^Vhr, Gg, Gg, Gll^Fp, Gll^Fp, Gll^Fp, Gg, Gs, Gs, Gg, Gll^Fp, Gll^Fp, Gs, Gll^Fp, Gs, Gg, Ww, Ww, Ww, Gg, Gs, Gs, Gg, Gg, Gg, Gll^Fp, Gll^Fp, Gll^Fp, Gs, Gs, Ww, Ww, Wo, Wo, Wo
Gg, Gg, Gg, Ww, Wo, Wo, Ww, Gg, Gg, Gg, Gll^Fp, Gg, Gg, Gll^Fp, Gll^Fp, Gll^Fp, Gll^Fp, Gll^Fp, Gg, Gg, Gd^Vhr, Gll^Fp, Gll^Fp, Gll^Fp, Gll^Fp, Gs, Gs, Gg, Gs, Gs, Gg, Gg, Gs, Gs, Gg, Gg, Gll^Fp, Gd^Vhr, Gll^Fp, Gll^Fp, Gs, Ds, Ww, Wo, Wo, Wo
Gg, Gg, Gd^Vhr, Ww, Ww, Ww, Gg, Gg, Gll^Fp, Gll^Fp, Gll^Fp, Gll^Fp, Gg, Gg, Gg, Gll^Fp, Gll^Fp, Gll^Fp, Gg, Gg, Gll^Fp, Gll^Fp, Gll^Fp, Gll^Fp, Gg, Gg, Gg, Gg, Gll^Fp, Gs, Gll^Fp, Gll^Fp, Gg, Gg, Gll^Fp, Gll^Fp, Gll^Fp, Gg, Gs, Gg, Gs, Ds, Ds, Ww, Ww, Wo
Gg, Gg, Gg, Gg, Gg, Gg, Gs, Gs, Gll^Fp, Gll^Fp, Gll^Fp, Gll^Fp, Gg, Gd^Vhr, Gg, Gll^Fp, Gg, Gg, Gs, Gg, Gg, Gll^Fp, Gg, Gll^Fp, Gg, Gd^Vhr, Gg, Gll^Fp, Gll^Fp, Gll^Fp, Gll^Fp, Gd^Vhr, Gg, Gg, Gg, Gll^Fp, Gll^Fp, Gll^Fp, Gg, Gs, Gs, Gg, Gg, Ds, Ww, Ww
Gs, Gs, Gll^Fp, Gll^Fp, Gll^Fp, Gll^Fp, Gll^Fp, Gs, Gs, Gs, Gs, Gg, Gg, Gg, Gg, Gg, Qxua, Gs, Gg, Gs, Re, Gg, Gs, Gg, Gs, Gg, Gg, Gll^Fp, Gs, Gs, Gg, Gll^Fp, Gg, Gg, Gg, Gg, Gg, Gg, Gg, Gg, Gll^Fp, Gll^Fp, Gll^Fp, Gg, Ds, Ww
Gs, Gg, Gll^Fp, Gll^Fp, Gll^Fp, Gs, Gg, Gg, Gg, Gg, Gg, Gs, Qxua, Qxua, Qxua, Qxua, Qxua, Qxua, Qxua, Re, Re, Re, Re, Re, Qxua, Gg, Qxua, Gs, Qxua, Qxua, Qxua, Gg, Gg, Gs, Gs, Gs, Gs, Gg, Gll^Fp, Gll^Fp, Gg, Gd^Vhr, Gll^Fp, Gs, Gg, Ds
Gs, Gg, Gg, Gs, Gs, Gs, Re, Gg, Qxua, Qxua, Qxua, Qxua, Qxua, Qxua, Qxua, Qxua, Qxua, Qxua, Qxua, Re, Re, Re, Re, Re, Qxua, Qxua, Qxua, Qxua, Qxua, Qxua, Qxua, Qxua, Qxua, Qxua, Qxua, Re, Re, Gg, Gg, Gg, Gll^Fp, Gg, Gg, Gs, Gs, Gg
Gg, Gs, Gs, Gd^Vhr, Re, Re, Re, Qxua, Qxua, Qxua, Qxua, Qxua, Qxua, Qxua, Qxua, Qxua, Qxua, Qxua, Qxua, Re, Re, Re, Re, Re, Qxua, Qxua, Qxua, Qxua, Qxua, Qxua, Qxua, Qxua, Qxua, Qxua, Qxua, Re, Re, Qxua, Qxua, Gg, Gs, Gll^Fp, Gll^Fp, Gll^Fp, Gll^Fp, Gs
Gg, Gg, Qxua, Qxua, Qxua, Re, Re, Qxua, Qxua, Qxua, Qxua, Qxua, Qxua, Qxua, Xol, Xos, Xos, Qxua, Rrc, Rrc, Rrc, Re, Rrc, Rrc, Rrc, Qxua, Qxua, Qxua, Qxua, Qxua, Xos, Qxua, Qxua, Qxua, Re, Re, Re, Qxua, Qxua, Qxua, Gg, Gs, Gll^Fp, Gll^Fp, Gll^Fp, Gg
Qxua, Qxua, Qxua, Qxua, Qxua, Re, Re, Re, Rrc, Qxua, Qxua, Qxua, Xos, Qxua, Qxua, Xol, Xol, Xos, Rrc, Cmy, Rrc, Rrc, Rrc, Cmy, Rrc, Xos, Xos, Qxua, Qxua, Xos, Xos, Xos, Rrc, Rrc, Rrc, Re, Qxua, Qxua, Qxua, Qxua, Qxua, Gs, Gll^Fp, Gll^Fp, Gs, Gg
Qxua, Qxua, Qxua, Qxua, Qxua, Qxua, Rrc, Rrc, Cmy, Rrc, Xol, Xos, Xos, Qxua, Rrc, Qxua, Rrc, Xol, Xos, Rrc, Cmy, Rrc, Cmy, Rrc, Xos, Xos, Rrc, Rrc, Rrc, Rrc, Rrc, Xos, Rrc, Cmy, Cmy, Rrc, Xos, Qxua, Qxua, Qxua, Qxua, Gs, Gs, Gs, Gs, Gs
Qxua, Qxua, Qxua, Qxua, Qxua, Qxua, Rrc, Cmy, Cmy, Rrc, Rrc, Xol, Xos, Rrc, Cmy, Rrc, Cmy, Rrc, Xos, Rrc, Cmy, Rrc, Cmy, Rrc, Xos, Rrc, Cmy, 2 Kmy, Cmy, Cmy, Rrc, Xos, Rrc, Rrc, Rrc, Rrc, Xos, Xos, Qxua, Qxua, Qxua, Qxua, Qxua, Qxua, Qxua, Qxua
Qxua, Qxua, Qxua, Qxua, Xos, Xos, Xos, Rrc, Rrc, Rrc, Rrc, Rrc, Xos, Rrc, Rrc, 3 Kmy, Cmy, Rrc, Xos, Rrc, Rrc, Rrc, Rrc, Rrc, Xos, Rrc, Rrc, Cmy, Rrc, Rrc, Xos, Xos, Rrc, Rrc, Rrc, Rrc, Xos, Xos, Xos, Qxua, Qxua, Qxua, Qxua, Qxua, Qxua, Qxua
Qxua, Qxua, Qxua, Qxua, Xos, Xos, Xos, Rrc, Rrc, Rrc, Rrc, Rrc, Rrc, Xos, Xos, Rrc, Rrc, Rrc, Rrc, Rrc, Rrc, Rrc, Rrc, Rrc, Rrc, Xos, Rrc, Rrc, Rrc, Xos, Xos, Rrc, Rrc, Rrc, Xol, Xol, Rrc, Xol, Xol, Xos, Qxua, Qxua, Qxua, Qxua, Qxua, Qxua
Qxua, Qxua, Qxua, Qxua, Xos, Xos, Xos, Xos, Xos, Rrc, Rrc, Rrc, Rrc, Xol, Xol, Xol, Rrc, Rrc, Gg^Sc, Rrc, Gg^Srjt, Gg^Srs, Gg^Srjl, Rrc, Gg^Sc, Rrc, Rrc, Rrc, Xos, Xos, Rrc, Rrc, Rrc, Xos, Rrc, Rrc, Rrc, Rrc, Rrc, Xos, Qxua, Qxua, Qxua, Qxua, Qxua, Qxua
Qxua, Qxua, Qxua, Qxua, Xos, Xos, Xos, Xos, Xos, Xos, Xos, Rrc, Cmy, Rrc, Rrc, Rrc, Rrc, Rrc, Rrc, Rrc, Gg^Srg, Gg^Sct, Gg^Sro, Rrc, Rrc, Rrc, Rrc, Rrc, Rrc, Rrc, Cmy, Rrc, Xos, Xos, Rrc, Cmy, 5 Kmy, Cmy, Rrc, Xos, Xos, Qxua, Qxua, Qxua, Qxua, Qxua
Qxua, Qxua, Qxua, Qxua, Qxua, Xos, Xos, Xos, Rrc, Rrc, Xol, Rrc, Rrc, Cmy, Rrc, Rrc, Gg^Srjt, Gg^Srs, Gg^Srjl, Rrc, Rrc, Gg^Srat, Rrc, Rrc, Gg^Srjt, Gg^Srs, Gg^Srjl, Rrc, Rrc, Cmy, Rrc, Rrc, Xol, Rrc, Rrc, Cmy, Rrc, Cmy, Rrc, Xos, Xos, Qxua, Qxua, Qxua, Qxua, Qxua
Qxua, Qxua, Qxua, Qxua, Qxua, Xos, Xos, Xos, Rrc, Rrc, Rrc, Xol, Xol, Rrc, Rrc, Rrc, Gg^Srg, Gg^Sct, Gg^Sro, Rrc, Rrc, Rrc, Rrc, Rrc, Gg^Srg, Gg^Sct, Gg^Sro, Rrc, Rrc, Rrc, Xol, Xol, Rrc, Rrc, Rrc, Rrc, Rrc, Rrc, Xos, Xos, Xos, Qxua, Qxua, Qxua, Qxua, Qxua
Qxua, Qxua, Qxua, Qxua, Qxua, Xos, Xos, Rrc, Cmy, Rrc, Cmy, Rrc, Rrc, Rrc, Rrc, Rrc, Rrc, Gg^Srat, Rrc, Rrc, Gg^Srj, Gg^Srot, Gg^Srjs, Rrc, Rrc, Gg^Srat, Rrc, Rrc, Rrc, Rrc, Rrc, Rrc, Cmy, Rrc, Rrc, Rrc, Rrc, Rrc, Xos, Xos, Qxua, Qxua, Qxua, Qxua, Qxua, Qxua
Qxua, Qxua, Qxua, Qxua, Xos, Xos, Xos, Rrc, Cmy, 4 Kmy, Cmy, Rrc, Xos, Rrc, Rrc, Gg^Sc, Rrc, Rrc, Rrc, Rrc, Gg^Srgt, Gg^Sc, Gg^Srst, Rrc, Rrc, Rrc, Rrc, Gg^Sc, Cmy, Rrc, Xos, Rrc, Rrc, Rrc, Rrc, Rrc, Rrc, Xos, Xos, Xos, Qxua, Qxua, Qxua, Qxua, Qxua, Qxua
Qxua, Qxua, Qxua, Qxua, Xos, Xos, Xos, Rrc, Rrc, Rrc, Rrc, Rrc, Xol, Xos, Xos, Rrc, Gg^Srjt, Gg^Srs, Gg^Srjl, Rrc, Rrc, Gg^Sra, Rrc, Rrc, Gg^Srjt, Gg^Srs, Gg^Srjl, Rrc, Rrc, Rrc, Rrc, Xos, Xos, Rrc, Rrc, Cmy, Rrc, Xos, Xos, Qxua, Qxua, Qxua, Qxua, Qxua, Qxua, Qxua
Qxua, Qxua, Qxua, Qxua, Xos, Xos, Xos, Xos, Xol, Xos, Xol, Xol, Rrc, Rrc, Rrc, Rrc, Gg^Srg, Gg^Sct, Gg^Sro, Rrc, Rrc, Rrc, Rrc, Rrc, Gg^Srg, Gg^Sct, Gg^Sro, Rrc, Xos, Rrc, Rrc, Xol, Xol, Xos, Xos, Rrc, Xos, Xos, Qxua, Qxua, Qxua, Qxua, Qxua, Qxua, Qxua, Qxua
Qxua, Qxua, Qxua, Qxua, Qxua, Xos, Xos, Xos, Rrc, Rrc, Rrc, Rrc, Rrc, Cmy, Rrc, Rrc, Rrc, Gg^Srat, Rrc, Rrc, Gg^Srjt, Gg^Srs, Gg^Srjl, Rrc, Rrc, Gg^Srat, Rrc, Rrc, Xos, Rrc, Rrc, Rrc, Rrc, Xos, Xos, Xos, Xos, Xos, Qxua, Qxua, Qxua, Qxua, Qxua, Qxua, Qxua, Qxua
Gs^Ft, Qxua, Qxua, Qxua, Qxua, Xos, Xos, Xos, Rrc, Rrc, Rrc, Rrc, Rrc, Rrc, Rrc, Xos, Rrc, Rrc, Gg^Sc, Rrc, Gg^Srg, Gg^Sct, Gg^Sro, Rrc, Gg^Sc, Rrc, Rrc, Rrc, Rrc, Xos, Rrc, Cmy, Rrc, Xos, Qxua, Xos, Qxua, Qxua, Qxua, Qxua, Qxua, Qxua, Qxua, Qxua, Qxua, Qxua
Gs^Ft, Gs, Qxua, Qxua, Qxua, Qxua, Qxua, Xos, Rrc, Cmy, Rrc, Rrc, Xos, Rrc, Xos, Xos, Rrc, Cmy, Cmy, Rrc, Rrc, Gg^Srat, Rrc, Rrc, Rrc, Rrc, Rrc, Cmy, Rrc, Xos, Xos, Rrc, Re, Re, Qxua, Qxua, Qxua, Qxua, Qxua, Qxua, Qxua, Qxua, Gs, Gs, Gs, Qxua
Gs^Ft, Gs^Ft, Gs, Qxua, Qxua, Qxua, Re, Re, Re, Rrc, Xol, Xos, Xos, Xos, Xos, Xos, Xos, Rrc, Rrc, Rrc, Xos, Rrc, Xos, Xos, Xos, Rrc, Xos, Rrc, Xos, Xos, Xos, Qxua, Re, Re, Re, Qxua, Qxua, Qxua, Gs, Gs, Gs, Gs, Gs^Ft, Gs, Gs^Ft, Gs
Hh, Gs^Ft, Gs, Gs, Re, Re, Re, Re, Qxua, Qxua, Qxua, Xos, Qxua, Xos, Xos, Xos, Xos, Xos, Xos, Xos, Xos, Xos, Qxua, Xos, Xos, Xos, Xos, Xos, Xos, Xos, Qxua, Qxua, Qxua, Re, Re, Qxua, Qxua, Qxua, Gs, Gd^Vhr, Gs, Gs, Gs^Ft, Gs^Ft, Gs^Ft, Gs^Ft
Mm, Hh, Hh, Gs, Re, Re, Qxua, Qxua, Qxua, Qxua, Qxua, Qxua, Qxua, Qxua, Qxua, Qxua, Qxua, Xos, Qxua, Xos, Qxua, Qxua, Qxua, Qxua, Qxua, Xos, Qxua, Qxua, Qxua, Qxua, Qxua, Qxua, Qxua, Re, Re, Qxua, Gs, Gs, Gs^Ft, Gs^Ft, Gs^Ft, Hh, Hh, Hh, Hh, Gs^Ft
Mm, Mm, Hh, Gs, Gs^Ft, Re, Gs^Ft, Qxua, Gs, Qxua, Qxua, Qxua, Qxua, Qxua, Qxua, Qxua, Qxua, Qxua, Qxua, Qxua, Qxua, Qxua, Qxua, Qxua, Qxua, Qxua, Qxua, Qxua, Qxua, Qxua, Qxua, Qxua, Gs, Gs, Gs, Gs, Gs, Gs, Hh, Gs^Ft, Hh, Hh, Mm, Mm, Mm, Hh
Mm, Mm, Mm, Hh, Hh, Gs^Ft, Gs^Ft, Gs^Ft, Gs, Gs, Gs, Gs, Gs, Qxua, Qxua, Qxua, Qxua, Qxua, Qxua, Qxua, Qxua, Qxua, Qxua, Qxua, Qxua, Qxua, Gs^Ft, Qxua, Qxua, Qxua, Gs, Gs, Gs^Ft, Gs^Ft, Gs^Ft, Gs, Hh, Hh, Mm, Hh, Mm, Mm, Mm, Mm, Mm, Mm
Mm, Mm, Mm, Mm, Mm, Hh, Hh, Gs, Gs, Gd^Vhr, Gs, Gs, Gs^Ft, Gs, Gs^Ft, Gs^Ft, Gs^Ft, Qxua, Qxua, Qxua, Gs, Gs, Gs, Qxua, Gs, Gs^Ft, Gs^Ft, Gs^Ft, Gs, Gs, Gs, Gs^Ft, Gs^Ft, Gs^Ft, Hh, Hh, Mm, Mm, Mm, Mm, Mm, Mm, Mm, Mm, Mm, Mm
Hh, Mm, Hh, Mm, Hh, Hh, Hh, Hh, Gs, Gs, Hh, Hh, Hh, Gs^Ft, Gs^Ft, Gs^Ft, Gs^Ft, Gs, Gs, Gs, Gs, Gs, Gs, Gs, Gs, Gs, Gs, Gs, Gs, Gs, Gs^Ft, Gs, Gs, Hh, Mm, Mm, Mm, Mm, Mm, Mm, Mm, Mm, Mm, Mm, Mm, Mm
Hh, Hh, Gs, Hh, Gs, Hh, Gs, Gs, Gs^Ft, Gs, Hh, Mm, Mm, Hh, Hh, Hh, Hh, Gs, Gs, Gd^Vhr, Gs, Gs^Ft, Gs^Ft, Gs, Gs^Ft, Gs^Ft, Gs^Ft, Gs^Ft, Gs^Ft, Gs^Ft, Gs, Gd^Vhr, Gs, Hh, Hh, Mm, Mm, Mm, Mm, Mm, Mm, Mm, Mm, Mm, Mm, Mm
Ds, Ds, Ds, Gs, Ds, Gs, Gs^Ft, Gs^Ft, Gs^Ft, Gs, Gs, Hh, Hh, Mm, Mm, Mm, Mm, Hh, Hh, Gs, Gs^Ft, Gs^Ft, Gs^Ft, Gs, Gs, Gs^Ft, Gs^Ft, Gs^Ft, Gs, Gs^Ft, Gs^Ft, Gs, Gs^Ft, Gs, Gs, Hh, Hh, Mm, Hh, Mm, Mm, Mm, Hh, Mm, Hh, Hh
Ww, Ww, Ww, Ww, Ww, Ds, Ds, Gs^Ft, Ds, Gs, Gs, Gd^Vhr, Gs, Hh, Hh, Hh, Hh, Hh, Gs, Gs, Gs, Gs^Ft, Gs, Gd^Vhr, Gs, Gs, Ds, Gs, Gs, Gs, Gs, Gs^Ft, Gs, Gs, Gs, Gs, Gs, Hh, Gs^Ft, Hh, Hh, Hh, Gs^Ft, Hh, Gs, Gs
Wo, Wo, Wo, Wo, Wo, Ww, Ww, Ww, Ww, Ds, Ds, Gs, Ds, Gs, Gs^Ft, Gs^Ft, Gs^Ft, Gs^Ft, Gs^Ft, Gs^Ft, Gs, Gs, Ds, Gs, Ds, Ds, Ww, Ds, Ww, Ds, Ds, Gs, Ds, Ds, Ds, Gs, Gs, Gs^Ft, Gs^Ft, Gs^Ft, Gs^Ft, Gs^Ft, Gs^Ft, Gs^Ft, Gs, Gs
Wo, Wo, Wo, Wo, Wo, Wo, Wo, Wo, Wo, Ww, Ww, Ww, Ww, Ds, Ds, Gs^Ft, Ds, Gs^Ft, Ds, Gs, Ds, Ds, Ww, Ww, Ww, Ww, Ww, Ww, Wo, Ww, Ww, Ww, Ww, Ww, Ww, Ds, Ds, Ds, Ww, Ds, Ds, Gs^Ft, Ds, Ds, Ds, Ds
Wo, Wo, Wo, Wo, Wo, Wo, Wo, Wo, Wo, Wo, Wo, Wo, Wo, Ww, Ww, Ww, Ww, Ds, Ww, Ww, Ww, Ww, Wo, Ww, Wo, Wo, Wo, Wo, Wo, Wo, Wo, Wo, Wo, Wo, Wo, Ww, Ww, Ww, Wo, Ww, Ww, Ww, Ww, Ww, Ww, Ww
Wo, Wo, Wo, Wo, Wo, Wo, Wo, Wo, Wo, Wo, Wo, Wo, Wo, Wo, Wo, Wo, Wo, Ww, Wo, Wo, Wo, Wo, Wo, Wo, Wo, Wo, Wo, Wo, Wo, Wo, Wo, Wo, Wo, Wo, Wo, Wo, Wo, Wo, Wo, Wo, Wo, Wo, Wo, Wo, Wo, Wo
Wo, Wo, Wo, Wo, Wo, Wo, Wo, Wo, Wo, Wo, Wo, Wo, Wo, Wo, Wo, Wo, Wo, Wo, Wo, Wo, Wo, Wo, Wo, Wo, Wo, Wo, Wo, Wo, Wo, Wo, Wo, Wo, Wo, Wo, Wo, Wo, Wo, Wo, Wo, Wo, Wo, Wo, Wo, Wo, Wo, Wo
Wo, Wo, Wo, Wo, Wo, Wo, Wo, Wo, Wo, Wo, Wo, Wo, Wo, Wo, Wo, Wo, Wo, Wo, Wo, Wo, Wo, Wo, Wo, Wo, Wo, Wo, Wo, Wo, Wo, Wo, Wo, Wo, Wo, Wo, Wo, Wo, Wo, Wo, Wo, Wo, Wo, Wo, Wo, Wo, Wo, Wo
Wo, Wo, Wo, Wo, Wo, Wo, Wo, Wo, Wo, Wo, Wo, Wo, Wo, Wo, Wo, Wo, Wo, Wo, Wo, Wo, Wo, Wo, Wo, Wo, Wo, Wo, Wo, Wo, Wo, Wo, Wo, Wo, Wo, Wo, Wo, Wo, Wo, Wo, Wo, Wo, Wo, Wo, Wo, Wo, Wo, Wo
Wo, Wo, Wo, Wo, Wo, Wo, Wo, Wo, Wo, Wo, Wo, Wo, Wo, Wo, Wo, Wo, Wo, Wo, Wo, Wo, Wo, Wo, Wo, Wo, Wo, Wo, Wo, Wo, Wo, Wo, Wo, Wo, Wo, Wo, Wo, Wo, Wo, Wo, Wo, Wo, Wo, Wo, Wo, Wo, Wo, Wo
