border_size=1
usage=map

Dd          , Dd          , Dd          , Dd          , Dd          , Dd          , Dd          , Dd          , Dd          , Dd          , Dd          , Dd          , Dd          , Dd          , Dd          , Dd          , Dd          , Dd          , Dd          , Dd          , Dd          , Dd          , Dd          , Dd          , Dd          , Dd          , Dd          , Dd          , Dd          , Dd          , Dd          , Dd          , Dd          , Dd          , Dd          , Dd          , Dd          , Dd          , Gs          , Gs          , Gs          , Gs          , Gs          , Gs          , Gs^Ft       , Gs^Ft       , Gs^Ft       , Gs^Ft       , Gs^Ft       
Dd          , Dd          , Dd          , Dd          , Dd          , Dd          , Dd          , Dd          , Dd          , Dd          , Dd          , Dd          , Dd          , Dd          , Dd          , Dd          , Dd          , Dd          , Dd          , Dd          , Dd          , Dd          , Dd          , Dd          , Dd          , Dd          , Dd          , Dd          , Dd          , Dd          , Dd          , Dd          , Dd          , Dd          , Dd          , Dd          , Dd          , Dd          , Gs          , Re^Vct      , Gs          , Gs^Ft       , Gs^Ft       , Gs          , Gs          , Gs^Ft       , Re^Vct      , Gs          , Gs          
Dd          , Dd          , Dd          , Dd          , Dd          , Dd          , Dd          , Dd          , Dd          , Dd          , Dd          , Dd          , Dd          , Dd          , Dd          , Dd          , Dd          , Dd          , Dd          , Dd          , Dd          , Dd          , Dd          , Dd          , Dd          , Dd          , Dd          , Dd          , Dd          , Dd          , Dd          , Dd          , Dd          , Dd          , Gs          , Gs          , Gs          , Gs          , Gs          , Gs          , Gs          , Gs^Ft       , Gs^Ft       , Gs          , Gs          , Gs          , Gs          , Gs          , Gs          
Dd          , Dd          , Dd          , Dd          , Dd          , Dd          , Dd          , Dd          , Dd          , Dd          , Dd          , Dd          , Dd          , Dd          , Dd          , Dd          , Dd          , Dd          , Dd          , Dd          , Dd          , Dd          , Dd          , Dd          , Dd          , Dd          , Dd          , Dd          , Dd          , Dd          , Dd          , Dd          , Gs^Ft       , Gs          , Re^Vct      , Gs          , Ce          , Re^Vct      , Gs          , Gs          , Gs          , Gs^Ft       , Gs          , Gs          , Re^Vct      , Gs          , Gs^Ft       , Gs^Ft       , Gs^Ft       
Dd          , Dd          , Dd          , Dd          , Dd          , Dd          , Dd          , Dd          , Dd          , Dd          , Dd          , Dd          , Dd          , Dd          , Dd          , Dd          , Dd          , Dd          , Dd          , Dd          , Dd          , Dd          , Dd          , Dd          , Dd          , Dd          , Dd          , Dd          , Dd          , Dd          , Dd          , Dd          , Gs^Ft       , Gs          , Gs          , Ce          , 1 Ke        , Ce          , Gs^Ft       , Gs^Ft       , Gs^Ft       , Gs          , Ce          , Ce          , Ce          , Gs          , Gs^Ft       , Gs^Ft       , Gs^Ft       
Dd          , Dd          , Ce          , Dd          , Ce          , Dd          , Ce          , Dd          , Dd          , Dd          , Dd          , Dd          , Dd          , Dd          , Dd          , Dd          , Dd          , Dd          , Dd          , Dd          , Dd          , Dd          , Dd          , Dd          , Dd          , Dd          , Dd          , Dd          , Dd          , Dd          , Dd          , Dd          , Dd          , Gs^Ft       , Gs          , Ce          , Ce          , Ce          , Gs^Ft       , Gs^Ft       , Gs^Ft       , Gs          , Ce          , 2 Ke        , Ce          , Gs          , Gs          , Gs^Ft       , Gs          
Gs^Ft       , Gs^Ft       , Ce          , Gs          , Gs          , Ce          , Ce          , Ce          , Gs^Ft       , Dd          , Dd          , Dd          , Dd          , Dd          , Dd          , Dd          , Dd          , Dd          , Dd          , Dd          , Dd          , Dd          , Dd          , Dd          , Dd          , Dd          , Hd          , Hd          , Hd          , Dd          , Dd          , Dd          , Dd          , Gs^Ft       , Gs          , Gs          , Gs          , Gs          , Gs          , Gs          , Re^Vct      , Gs          , Gs          , Gs^Ft       , Gs          , Gs          , Re^Vct      , Gs          , Gs^Ft       
Gs          , Gs^Ft       , Ce          , Re^Vct      , Gs^Ft       , Gs          , Gs          , Re^Vct      , Gs^Ft       , Gs^Ft       , Gs          , Gs          , Re^Vct      , Dd          , Dd          , Dd          , Dd          , Dd          , Dd          , Dd          , Dd          , Dd          , Dd          , Dd          , Dd          , Dd          , Ds          , Ds          , Ds          , Hd          , Ds          , Dd          , Hd          , Hd          , Hd          , Gs          , Gs^Ft       , Re^Vct      , Gs          , Gs          , Gs          , Gs          , Gs          , Gs^Ft       , Gs^Ft       , Gs          , Gs          , Gs          , Gs^Ft       
Gs          , Gs          , Gs          , Gs^Ft       , Ce          , Ce          , Ce          , Gs          , Gs          , Gs          , Gs^Ft       , Gs^Ft       , Gs          , Gs          , Gs          , Dd          , Re^Vct      , Dd          , Gs^Ft       , Gs^Ft       , Gs^Ft       , Gs^Ft       , Gs^Ft       , Hd          , Ds          , Ds          , Ww          , Ww          , Ww          , Ww          , Ww          , Ds          , Ds          , Ds          , Ds          , Dd          , Dd          , Gs          , Gs^Ft       , Gs^Ft       , Gs^Ft       , Gs^Ft       , Dd          , Gs^Ft       , Gs^Ft       , Gs^Ft       , Dd          , Gs^Ft       , Dd          
Gs^Ft       , Gs          , Gs          , Gs^Ft       , Ce          , 3 Ke        , Ce          , Ce          , Gs          , Re^Vct      , Gs^Ft       , Gs^Ft       , Gs          , Gs^Ft       , Gs^Ft       , Gs          , Gs          , Gs          , Gs          , Gs          , Gs          , Gs          , Hd          , Hd          , Ds          , Ww          , Wo          , Wo          , Ww          , Wo          , Wo          , Ww          , Ww          , Ww          , Ww          , Ds          , Hd          , Dd          , Hd          , Dd          , Dd          , Dd          , Hd          , Dd          , Dd          , Dd          , Hd          , Dd          , Hd          
Gs^Ft       , Gs^Ft       , Re^Vct      , Gs          , Gs          , Ce          , Gs          , Gs          , Ce          , Gs          , Gs          , Gs          , Gs          , Gs^Ft       , Gs^Ft       , Gs^Ft       , Gs          , Gs          , Gs^Ft       , Re^Vct      , Hd          , Gs^Ft       , Ds          , Ds          , Ww          , Ww          , Wwf         , Wwf         , Ww          , Ww          , Ww          , Ww          , Wo          , Wo          , Ww          , Ds          , Ds          , Hd          , Hd          , Hd          , Ds          , Hd          , Ds          , Hd          , Ds          , Hd          , Ds          , Hd          , Ds          
Dd          , Gs^Ft       , Gs          , Gs          , Gs^Ft       , Gs          , Ce          , Ce          , Ce          , Ce          , Gs          , Re^Vct      , Gs          , Gs          , Gs          , Gs          , Hd          , Gs^Ft       , Gs^Ft       , Hd          , Ds          , Ds          , Ww          , Ww          , Wo          , Ww          , Wo          , Wo          , Ww          , Wo          , Wo          , Ww          , Ww          , Wwf         , Wo          , Ww          , Ww          , Ds          , Ww          , Ds          , Ww          , Ww          , Ww          , Ww          , Ww          , Ds          , Ww          , Ww          , Ww          
Ds          , Dd          , Dd          , Gs^Ft       , Gs^Ft       , Gs          , Ce          , 4 Ke        , Ce          , Ce          , Dd          , Gs^Ft       , Gs^Ft       , Gs^Ft       , Ds          , Hd          , Ds          , Hd          , Ds          , Ds          , Ww          , Ww          , Wo          , Wo          , Wo          , Ww          , Ww          , Wo          , Ww          , Wo          , Wwf         , Ww          , Wo          , Wwf         , Wo          , Wo          , Wo          , Ww          , Wo          , Ww          , Wo          , Wo          , Wo          , Wo          , Wo          , Ww          , Wo          , Wo          , Wo          
Ww          , Dd          , Dd          , Dd          , Dd          , Dd          , Dd          , Ce          , Dd          , Dd          , Dd          , Dd          , Ds          , Ds          , Ww          , Ww          , Ww          , Ds          , Ww          , Ww          , Wo          , Wo          , Ww          , Wo          , Ww          , Ww          , Ww          , Ww          , Wo          , Wwf         , Ww          , Wo          , Ww          , Ww          , Wo          , Ww          , Ww          , Wo          , Ww          , Wo          , Ww          , Ww          , Ww          , Ww          , Ww          , Wo          , Ww          , Ww          , Ww          
Wo          , Ww          , Ww          , Dd          , Ww          , Ds          , Ds          , Dd          , Dd          , Dd          , Ds          , Ds          , Ww          , Ww          , Wo          , Wo          , Wo          , Ww          , Wo          , Wo          , Ww          , Ww          , Ds          , Ww          , Ww          , Wo          , Wo          , Wwf         , Ww          , Wo          , Ww          , Ww          , Wo          , Ww          , Ww          , Ww          , Ds          , Ww          , Ds          , Ww          , Ds          , Ds          , Gd          , Ds          , Ds          , Ww          , Ds          , Ds          , Gd          
Ww          , Wo          , Wo          , Ww          , Wo          , Ww          , Ww          , Ds          , Ds          , Ds          , Ww          , Ww          , Wo          , Wo          , Ww          , Ww          , Ww          , Wo          , Ww          , Ww          , Ds          , Ds          , Hd          , Ds          , Ds          , Ww          , Ww          , Wwf         , Wo          , Ww          , Wwf         , Wo          , Ww          , Ww          , Ds          , Hd          , Hd          , Ds          , Hd          , Hd          , Gd          , Gd          , Gd          , Gd          , Gd          , Gd          , Gd          , Gd          , Gd          
Ds          , Ww          , Ww          , Wo          , Ww          , Wo          , Wo          , Ww          , Ww          , Ww          , Wo          , Wo          , Ww          , Ww          , Ds          , Ds          , Ds          , Ww          , Ds          , Ds          , Gd          , Gd          , Gd          , Hd          , Hd          , Ww          , Ww          , Wo          , Ww          , Wo          , Wwf         , Ww          , Ww          , Ds          , Hd          , Hd          , Gd          , Gd          , Gd          , Gd          , Gd          , Gd          , Gd          , Gd          , Gd          , Gd          , Gd          , Gd          , Gd          
Gd          , Ds          , Ds          , Ww          , Ds          , Ww          , Ww          , Wo          , Wo          , Wo          , Ww          , Ww          , Ds          , Ds          , Gd          , Gd          , Gd          , Gd          , Gd          , Gd          , Gd          , Gd          , Gd          , Gd          , Hd          , Ds          , Ds          , Ww          , Ds          , Ww          , Ww          , Ww          , Ds          , Ds          , Gd          , Gd          , Gd          , Gd          , Gd          , Gd          , Gd^Fdf      , Gd^Fdf      , Gd^Fdf      , Gd^Fdf      , Gd^Fdf      , Gd^Fdf      , Gd^Fdf      , Gd          , Gd          
Gd          , Gd          , Gd          , Gd          , Gd          , Ds          , Ds          , Ww          , Ww          , Ww          , Ds          , Ds          , Gd          , Gd          , Gd          , Gd          , Gd          , Gd          , Gd^Fdf      , Gd^Fdf      , Gd          , Gd^Fdf      , Gd^Fdf      , Gd          , Gd          , Hd          , Gd          , Hd          , Hd          , Ds          , Hd          , Hd          , Hd          , Gd          , Gd          , Gd          , Gd          , Gd          , Gd^Fdf      , Gd^Fdf      , Gd^Fdf      , Gd          , Gd^Fdf      , Gd^Fdf      , Gd          , Gd          , Gd^Fdf      , Gd^Fdf      , Gd^Fdf      
Gd          , Gd          , Gd          , Gd          , Gd          , Gd          , Gd          , Ds          , Gd          , Ds          , Gd          , Gd          , Gd          , Gd          , Gd^Fdf      , Gd          , Gd^Fdf      , Gd^Fdf      , Gg^Ve       , Gd^Fdf      , Gd          , Gd^Fdf      , Gd^Fdf      , Gd          , Gd^Fdf      , Gd^Fdf      , Gd^Fdf      , Gd          , Gd          , Gd          , Gd          , Hd          , Gd          , Gd          , Gd^Fdf      , Gd^Fdf      , Gd^Fdf      , Gd^Fdf      , Gd^Fdf      , Gd^Fdf      , Gd^Fdf      , Gd          , Gd^Fdf      , Gd^Fdf      , Gd^Fdf      , Gd          , Gd^Fdf      , Gd^Fdf      , Gd^Fdf      
Gd^Fdf      , Gd          , Gd^Fdf      , Gd          , Gd^Fdf      , Gd          , Gd^Fdf      , Gd^Fdf      , Gd^Fdf      , Gd^Fdf      , Gd          , Gd          , Gd^Fdf      , Gd^Fdf      , Gd^Fdf      , Gd^Fdf      , Gd^Fdf      , Gd^Fdf      , Gd^Fdf      , Gd^Fdf      , Gd^Fdf      , Gd          , Gd^Fdf      , Gd          , Gd          , Gd^Fdf      , Gd^Fdf      , Gd^Fdf      , Gd          , Gd          , Gd^Fdf      , Gd^Fdf      , Gd          , Gd^Fdf      , Gd^Fdf      , Gg^Ve       , Gd^Fdf      , Gd^Fdf      , Gd          , Gd^Fdf      , Gd^Fdf      , Gd^Fdf      , Gd^Fdf      , Gd^Fdf      , Gd          , Gd^Fdf      , Gd          , Gd^Fdf      , Gd^Fdf      
Gd^Fdf      , Gd          , Gd^Fdf      , Gd^Fdf      , Gd^Fdf      , Gd^Fdf      , Gd          , Gd^Fdf      , Gd^Fdf      , Gd          , Gd^Fdf      , Gd^Fdf      , Gd^Fdf      , Gd          , Gd          , Gd^Fdf      , Gd^Fdf      , Gd^Fdf      , Hhd^Fdf     , Gd^Fdf      , Gd^Fdf      , Gd^Fdf      , Gd^Fdf      , Gd^Fdf      , Gd^Fdf      , Gd^Fdf      , Gd^Fdf      , Gd^Fdf      , Gd          , Gd^Fdf      , Gd^Fdf      , Gd^Fdf      , Gd          , Gd^Fdf      , Gd^Fdf      , Gd^Fdf      , Gd^Fdf      , Gd          , Gd          , Gd^Fdf      , Gd^Fdf      , Gd          , Gd          , Gd^Fdf      , Gd^Fdf      , Gd          , Gd          , Gd^Fdf      , Gd^Fdf      
Gd^Fdf      , Gd          , Gd          , Gd^Fdf      , Gd^Fdf      , Gd          , Gd^Fdf      , Gd          , Gd^Fdf      , Gd^Fdf      , Gd^Fdf      , Gd^Fdf      , Gd^Fdf      , Gd^Fdf      , Gd          , Hhd^Fdf     , Hhd^Fdf     , Hhd^Fdf     , Gd          , Hhd^Fdf     , Gd^Fdf      , Gd^Fdf      , Gd          , Gd^Fdf      , Gd^Fdf      , Gd          , Gd^Fdf      , Gd^Fdf      , Gd^Fdf      , Gd          , Gd^Fdf      , Gd^Fdf      , Gd^Fdf      , Gd          , Gd^Fdf      , Gd^Fdf      , Gd^Fdf      , Gd          , Gd^Fdf      , Gd^Fdf      , Gd^Fdf      , Gd          , Gd^Fdf      , Gd^Fdf      , Gd^Fdf      , Gd^Fdf      , Gg^Ve       , Gd^Fdf      , Gd^Fdf      
Gd^Fdf      , Gd^Fdf      , Gd^Fdf      , Gd^Fdf      , Gd^Fdf      , Gd^Fdf      , Gd^Fdf      , Gd^Fdf      , Gd^Fdf      , Gd          , Gd          , Gd          , Gd^Fdf      , Gd^Fdf      , Gd^Fdf      , Gd^Fdf      , Gd^Fdf      , Gd^Fdf      , Gd          , Hhd^Fdf     , Gd^Fdf      , Gd^Fdf      , Gd          , Gd^Fdf      , Gd^Fdf      , Gd          , Gd          , Gd^Fdf      , Gg^Ve       , Gd^Fdf      , Gd^Fdf      , Gd^Fdf      , Gd          , Gd^Fdf      , Gd^Fdf      , Gd^Fdf      , Gd^Fdf      , Gd^Fdf      , Gd^Fdf      , Gd^Fdf      , Gg^Ve       , Gd^Fdf      , Gd          , Gd          , Gd          , Gd^Fdf      , Gd^Fdf      , Gd^Fdf      , Gd^Fdf      
Gd^Fdf      , Gd^Fdf      , Gd^Fdf      , Gd^Fdf      , Gg^Ve       , Gd^Fdf      , Gd^Fdf      , Gd^Fdf      , Gd^Fdf      , Gd^Fdf      , Gd^Fdf      , Gd^Fdf      , Gd^Fdf      , Gd^Fdf      , Gd          , Gd^Fdf      , Gd^Fdf      , Gd^Fdf      , Gd^Fdf      , Gd          , Gd^Fdf      , Gd^Fdf      , Gd          , Gd^Fdf      , Gd^Fdf      , Gd^Fdf      , Gd^Fdf      , Gd^Fdf      , Gd^Fdf      , Gd^Fdf      , Gd^Fdf      , Gd^Fdf      , Gd          , Gd          , Gd          , Gd^Fdf      , Gd          , Gd^Fdf      , Gd^Fdf      , Gd^Fdf      , Gd          , Gd          , Gd          , Urb         , Gd          , Gd^Fdf      , Gd^Fdf      , Gd^Fdf      , Gd^Fdf      
Gd^Fdf      , Gd^Fdf      , Gd^Fdf      , Gd^Fdf      , Gd^Fdf      , Gd^Fdf      , Gd          , Gd^Fdf      , Gd^Fdf      , Gd^Fdf      , Gd^Fdf      , Gd^Fdf      , Gd^Fdf      , Gd^Fdf      , Gd          , Gd^Fdf      , Gd^Fdf      , Gd^Fdf      , Gd^Fdf      , Gd^Fdf      , Gg^Ve       , Gd^Fdf      , Gd^Fdf      , Gd^Fdf      , Gd^Fdf      , Gd          , Gd^Fdf      , Gd^Fdf      , Gd^Fdf      , Gd^Fdf      , Gd          , Gd^Fdf      , Gd^Fdf      , Gd^Fdf      , Gd^Fdf      , Gd^Fdf      , Gd^Fdf      , Gd          , Gd^Fdf      , Gd^Fdf      , Gd          , Gg^Ve       , Ce          , Gd          , Ce          , Gd          , Gd^Fdf      , Gd^Fdf      , Gd^Fdf      
Gd^Fdf      , Gd^Fdf      , Gd^Fdf      , Gd          , Gd          , Gd          , Gd^Fdf      , Gd^Fdf      , Gd^Fdf      , Gd^Fdf      , Gd          , Gd^Fdf      , Gd^Fdf      , Gd^Fdf      , Gd^Fdf      , Gd          , Gd^Fdf      , Gd^Fdf      , Gd^Fdf      , Gd^Fdf      , Gd^Fdf      , Gd^Fdf      , Gd^Fdf      , Gd^Fdf      , Gd          , Gd          , Gd^Fdf      , Gd^Fdf      , Gd^Fdf      , Gd^Fdf      , Gd^Fdf      , Gd          , Gd          , Gd^Fdf      , Gd^Fdf      , Gd^Fdf      , Gd^Fdf      , Gd          , Gd^Fdf      , Gd^Fdf      , Gd          , Ce          , Ce          , 6 Ke        , Ce          , Ce          , Gd^Fdf      , Gd^Fdf      , Gd^Fdf      
Gd^Fdf      , Gd^Fdf      , Gd^Fdf      , Gd^Fdf      , Gd^Fdf      , Gd^Fdf      , Gd^Fdf      , Gd^Fdf      , Gd^Fdf      , Gd          , Hhd         , Gd          , Gd^Fdf      , Gd^Fdf      , Gd^Fdf      , Gd^Fdf      , Gd^Fdf      , Gd^Fdf      , Gd^Fdf      , Gd          , Gd          , Gd^Fdf      , Gd          , Gd^Fdf      , Gd^Fdf      , Gd^Fdf      , Gd^Fdf      , Gd^Fdf      , Gd^Fdf      , Gg^Ve       , Gd^Fdf      , Gd^Fdf      , Gd          , Gd^Fdf      , Gd^Fdf      , Gd^Fdf      , Hhd^Fdf     , Gd^Fdf      , Gd^Fdf      , Gd^Fdf      , Gd^Fdf      , Gd          , Gd          , Ce          , Gd          , Gd          , Gd^Fdf      , Gd^Fdf      , Gd^Fdf      
Gd^Fdf      , Gd^Fdf      , Gd^Fdf      , Gd^Fdf      , Hhd^Fdf     , Gd^Fdf      , Hhd         , Hhd         , Hhd^Fdf     , Hhd^Fdf     , Gg^Ve       , Hhd         , Hhd^Fdf     , Gd^Fdf      , Gd^Fdf      , Gd^Fdf      , Hhd^Fdf     , Gd^Fdf      , Gd^Fdf      , Gd^Fdf      , Gd^Fdf      , Gd          , Gd^Fdf      , Gd^Fdf      , Gd^Fdf      , Gd^Fdf      , Gd          , Gd          , Gd^Fdf      , Gd^Fdf      , Gd^Fdf      , Gd^Fdf      , Gd^Fdf      , Gd^Fdf      , Gd^Fdf      , Gd          , Hhd^Fdf     , Hhd^Fdf     , Gd^Fdf      , Gd^Fdf      , Gd^Fdf      , Gd^Fdf      , Gd^Fdf      , Gg^Ve       , Gd^Fdf      , Gd^Fdf      , Gd^Fdf      , Gd^Fdf      , Mm          
Hhd         , Hhd         , Hhd^Fdf     , Hhd^Fdf     , Gd^Fdf      , Hhd^Fdf     , Gd^Fdf      , Gd^Fdf      , Gd^Fdf      , Gd^Fdf      , Gd          , Gd^Fdf      , Gd^Fdf      , Hhd^Fdf     , Gd^Fdf      , Hhd^Fdf     , Gd^Fdf      , Hhd^Fdf     , Hhd         , Gd^Fdf      , Hhd         , Gd^Fdf      , Gd^Fdf      , Gd^Fdf      , Gd^Fdf      , Gd^Fdf      , Gd^Fdf      , Gd^Fdf      , Hhd         , Hhd         , Hhd         , Gd^Fdf      , Gd^Fdf      , Gd^Fdf      , Gd^Fdf      , Gd          , Gd          , Gd          , Gd^Fdf      , Gd^Fdf      , Gd^Fdf      , Gd^Fdf      , Gd^Fdf      , Gd^Fdf      , Gd^Fdf      , Gd^Fdf      , Mm          , Mm          , Mm          
Gd^Fdf      , Gd^Fdf      , Gd^Fdf      , Gd^Fdf      , Gd^Fdf      , Gd^Fdf      , Gd^Fdf      , Gd^Fdf      , Gd^Fdf      , Gd          , Gd          , Gd          , Gd          , Gd^Fdf      , Gd          , Gd          , Gd          , Gd^Fdf      , Gd^Fdf      , Hhd         , Mm          , Hhd^Fdf     , Hhd^Fdf     , Gd^Fdf      , Gd^Fdf      , Gd^Fdf      , Hhd^Fdf     , Hhd^Fdf     , Mm          , Hhd         , Mm          , Hhd         , Hhd^Fdf     , Gd^Fdf      , Hhd         , Gd^Fdf      , Gd^Fdf      , Gd^Fdf      , Gd^Fdf      , Gd^Fdf      , Gd^Fdf      , Gd^Fdf      , Gd^Fdf      , Gd^Fdf      , Mm          , Mm          , Mm          , Mm          , Mm          
Gd^Fdf      , Gd^Fdf      , Gd^Fdf      , Gd^Fdf      , Gd^Fdf      , Gd^Fdf      , Gd^Fdf      , Gd^Fdf      , Gd          , Gd          , Ce          , Ce          , Ce          , Gd          , Gd          , Gg^Ve       , Gd          , Gd^Fdf      , Hhd         , Hhd         , Mm          , Mm          , Mm^Xm       , Hhd         , Hhd         , Hhd^Fdf     , Mm          , Mm          , Mm          , Mm^Xm       , Mm^Xm       , Mm          , Mm^Xm       , Hhd^Fdf     , Mm          , Hhd         , Hhd         , Gd^Fdf      , Hhd         , Gd^Fdf      , Hhd         , Gd^Fdf      , Mm          , Mm          , Mm          , Mm          , Mm          , Mm          , Mm          
Gd^Fdf      , Gd^Fdf      , Gd^Fdf      , Gd^Fdf      , Gd^Fdf      , Gd^Fdf      , Gd^Fdf      , Gd^Fdf      , Gg^Ve       , Gd          , Ce          , 5 Ke        , Ce          , Ce          , Gd          , Gd          , Hhd         , Hhd         , Hhd^Fdf     , Mm          , Hhd         , Mm          , Mm          , Mm^Xm       , Mm^Xm       , Mm          , Mm          , Mm          , Mm^Xm       , Mm          , Mm^Vo       , Mm^Xm       , Mm          , Mm^Xm       , Mm^Xm       , Mm          , Mm^Xm       , Mm^Xm       , Mm^Xm       , Hhd         , Mm^Xm       , Mm^Xm       , Mm^Xm       , Mm          , Mm          , Mm          , Mm          , Mm          , Mm          
Gd^Fdf      , Gd^Fdf      , Gg^Ve       , Gd^Fdf      , Gd^Fdf      , Gd^Fdf      , Gd^Fdf      , Gd          , Gd          , Gd          , Gd          , Ce          , Ce          , Ce          , Hhd^Fdf     , Hhd^Fdf     , Mm^Xm       , Hhd^Fdf     , Hhd         , Hhd         , Mm          , Hhd         , Mm          , Mm          , Mm          , Mm          , Mm^Xm       , Mm^Xm       , Mm^Vo       , Mm^Xm       , Mm^Xm       , Mm^Xm       , Mm          , Mm^Xm       , Mm^Xm       , Mm^Xm       , Mm^Vo       , Mm          , Mm          , Mm^Xm       , Mm          , Mm          , Mm          , Mm^Xm       , Mm^Xm       , Mm^Xm       , Mm          , Mm          , Mm          
Gd^Fdf      , Gd^Fdf      , Gd^Fdf      , Gd^Fdf      , Gd^Fdf      , Gd^Fdf      , Gd^Fdf      , Gd^Fdf      , Gd^Fdf      , Gd          , Hhd^Fdf     , Gd          , Hhd^Fdf     , Hhd         , Mm^Xm       , Mm^Xm       , Mm^Xm       , Mm          , Mm          , Mm          , Mm          , Mm          , Mm^Xm       , Hhd         , Hhd         , Mm          , Mm          , Mm^Xm       , Mm^Xm       , Mm          , Mm          , Mm          , Hhd         , Mm^Vo       , Hhd         , Mm^Xm       , Hhd         , Mm          , Mm          , Mm          , Mm          , Mm          , Mm          , Mm          , Mm^Vo       , Mm^Xm       , Mm          , Mm          , Mm          
Gd^Fdf      , Gd^Fdf      , Gd^Fdf      , Gd^Fdf      , Gd^Fdf      , Gd^Fdf      , Hhd^Fdf     , Gd^Fdf      , Hhd         , Hhd         , Mm          , Hhd^Fdf     , Mm          , Mm          , Mm          , Mm          , Hhd         , Hhd         , Mm          , Mm^Xm       , Mm^Xm       , Mm          , Mm          , Mm^Xm       , Mm^Xm       , Hhd         , Hhd         , Mm          , Mm          , Mm          , Mm          , Mm^Xm       , Mm^Xm       , Hhd         , Hhd         , Hhd         , Mm          , Mm          , Mm          , Mm          , Mm          , Mm          , Mm          , Mm^Xm       , Mm^Xm       , Mm^Xm       , Mm^Xm       , Mm          , Mm^Xm       
Hhd^Fdf     , Gd^Fdf      , Hhd^Fdf     , Gd^Fdf      , Hhd         , Hhd^Fdf     , Hhd^Fdf     , Hhd^Fdf     , Mm^Xm       , Mm          , Mm          , Mm          , Mm          , Mm^Xm       , Mm^Xm       , Hhd         , Gd^Vo       , Mm          , Mm          , Mm          , Mm          , Mm^Xm       , Mm          , Mm          , Mm          , Mm          , Mm^Xm       , Hhd         , Hhd         , Hhd         , Mm^Xm       , Mm          , Mm          , Mm^Xm       , Mm          , Mm          , Hhd         , Hhd         , Mm          , Hhd         , Hhd         , Hhd         , Hhd         , Xu          , Xu          , Xu          , Xu          , Mm^Xm       , Xu          
Hhd         , Hhd^Fdf     , Hhd^Fdf     , Hhd^Fdf     , Hhd         , Hhd         , Hhd         , Mm          , Mm          , Mm^Xm       , Mm^Xm       , Mm          , Mm          , Mm          , Mm          , Mm^Xm       , Mm          , Hhd         , Mm^Xm       , Mm^Xm       , Mm^Xm       , Mm          , Hhd         , Gd^Vo       , Mm^Xm       , Mm^Xm       , Mm          , Mm^Xm       , Mm^Xm       , Mm          , Mm          , Mm^Xm       , Mm^Xm       , Mm          , Mm          , Mm          , Mm^Xm       , Hhd         , Uu          , Uh          , Uh          , Uh          , Co          , Uu^Vu       , Uh          , Xu          , Xu          , Xu          , Xu          
Mm          , Hhd         , Hhd         , Hhd         , Mm          , Mm          , Mm          , Mm^Xm       , Mm^Xm       , Mm          , Mm          , Mm          , Hhd         , Hhd         , Mm^Xm       , Mm          , Mm          , Mm^Xm       , Mm          , Mm          , Mm^Xm       , Mm^Xm       , Mm^Xm       , Hhd         , Hhd         , Mm          , Hhd         , Mm          , Mm          , Mm^Xm       , Mm^Xm       , Mm          , Mm          , Mm          , Mm^Vo       , Mm^Xm       , Xu          , Xu          , Uu          , Ur          , Ur          , Uu          , 7 Ko        , Co          , Uh          , Xu          , Xu          , Xu          , Xu          
Mm          , Mm^Xm       , Mm^Xm       , Mm          , Mm          , Mm^Xm       , Mm          , Mm          , Mm          , Mm^Xm       , Gd^Vo       , Hhd         , Mm^Xm       , Mm          , Mm          , Mm^Xm       , Mm^Xm       , Mm^Xm       , Gd^Vo       , Mm          , Mm^Xm       , Mm          , Mm          , Mm          , Hhd         , Hhd         , Mm^Xm       , Hhd         , Hhd         , Hhd         , Mm          , Mm^Xm       , Mm^Xm       , Mm^Xm       , Mm^Xm       , Mm^Xm       , Xu          , Xu          , Uu          , Ce          , 8 Ke        , Ur          , Uu          , Co          , Uu          , Uh          , Xu          , Xu          , Xu          
Mm          , Mm          , Mm          , Mm^Xm       , Mm          , Gd^Vo       , Mm          , Mm^Xm       , Mm^Xm       , Mm          , Hhd         , Mm          , Mm          , Mm          , Mm^Xm       , Mm          , Mm          , Mm          , Mm          , Mm          , Mm          , Mm^Xm       , Mm^Xm       , Mm          , Mm          , Mm          , Mm          , Mm^Xm       , Mm^Xm       , Hhd         , Mm          , Mm          , Mm          , Mm          , Mm          , Mm^Xm       , Xu          , Xu          , Uu^Vu       , Ce          , Ce          , Ur          , Ur          , Uu^Uf       , Uu^Uf       , Uu^Uf       , Uh          , Xu          , Xu          
Mm          , Mm^Xm       , Mm          , Mm          , Mm^Xm       , Mm          , Mm          , Mm          , Mm          , Mm^Xm       , Mm          , Hhd         , Mm^Xm       , Mm^Xm       , Mm          , Mm          , Mm          , Mm^Xm       , Mm          , Mm          , Mm          , Mm          , Mm          , Mm          , Mm^Xm       , Mm          , Mm          , Mm          , Mm          , Mm          , Mm          , Mm          , Mm          , Mm          , Mm^Xm       , Mm^Xm       , Xu          , Xu          , Xu          , Uu          , Uh          , Uu^Uf       , Uu^Uf       , Ur          , Ur          , Uu^Uf       , Uh          , Xu          , Xu          
Mm          , Mm          , Mm          , Mm          , Mm          , Mm          , Mm          , Mm          , Mm          , Mm          , Mm          , Mm          , Mm          , Mm          , Mm          , Mm          , Mm          , Mm          , Mm          , Mm          , Mm          , Mm          , Mm          , Mm          , Mm          , Mm          , Mm          , Mm          , Mm          , Mm          , Mm          , Mm          , Mm          , Mm          , Mm^Xm       , Mm^Xm       , Xu          , Xu          , Xu          , Xu          , Xu          , Uh          , Uh          , Uu          , Ur          , Uu          , Uu          , Uh          , Uh          
