border_size=1
usage=map

Xuc         , Xuc         , Xuc         , Xuc         , Xuc         , Xu          , Qlf         , Qlf         , Qlf         , Qlf         , Uu          , Uu          , Uu          , Uu          , Qlf         , Xu          , Qlf         , Xu          , Xu          , Xu          , Xu          , Xu          , Ur          , Ur          
Xuc         , Xuc         , Xuc         , Xuc         , Xuc         , Xu          , Xu          , Qlf         , Qlf         , Uu          , Qlf         , Uu          , Uu          , Uu          , Qlf         , Qlf         , Qlf         , Qlf         , Xu          , Xu          , Xu          , Uu^Uf       , Uu          , Ur          
Uu          , Xuc         , Ur          , Ur          , Uu^Uf       , Xuc         , Xu          , Qlf         , Xu          , Qlf         , Qxu         , Uu          , Qxu         , Qlf         , Xu          , Qlf         , Xu          , Xu          , Xu          , Xu          , Ur          , Uu          , Ur          , Uu          
Ur          , Uu          , 1 Ur        , Uu          , Uu          , Ur          , Ur          , Xu          , Cud         , Xu          , Uu          , Qxu         , Uu          , Xu          , Cud         , Xu          , Xu          , Xu          , Uu          , Uu          , Uu          , Ur          , Uu          , Uu          
Ur          , Uu          , Uu^Uf       , Uu          , Ur          , Uu          , Ur          , Uu          , Cud         , Cud         , Ur          , Uu          , Ur          , Cud         , 7 Cud       , Ur          , Uu^Vud      , Uu^Vud      , Ur          , Ur          , Uu          , Xuc         , Xuc         , Xuc         
Xuc         , Xuc         , Xuc         , Xuc         , Uu          , Uu          , Uu          , Uu          , Ur          , Uu          , Uu          , Ur          , Uu          , Uu          , Uu          , Ur          , Ur          , Uu^Vud      , Ur          , Uu          , Xuc         , Xuc         , Xuc         , Xuc         
Xuc         , Xuc         , Xuc         , Uu^Vud      , Ur          , Xuc         , Uu          , Ur          , Cud         , Uu          , Ur          , Uu          , Ur          , Ur          , Ur          , Uu          , Cud         , Uu          , Uu          , Uu          , Xuc         , Xuc         , Xuc         , Xuc         
Xuc         , Xuc         , Uu          , Ur          , Uu^Uf       , Xuc         , Xuc         , Ur          , Cud         , Ur          , Cud         , Cud         , Cud         , Cud         , Cud         , Ur          , Uu          , Cud         , Uu          , Uu^Uf       , Uu^Uf       , Xuc         , Uu          , Xuc         
Xuc         , Xuc         , Uu^Vud      , Ur          , Uu^Uf       , Xuc         , Xuc         , Uu          , Ur          , Ur          , Cud         , Cud         , 2 Kud       , Cud         , Cud         , Ur          , Uu          , Cud         , Uu          , Uu^Uf       , Uu          , Uu          , Ur          , Uu          
Xuc         , Xuc         , Uu^Vud      , Uu^Vud      , Xuc         , Xuc         , Uu          , Uu          , Uu^Vud      , Ur          , Cud         , Cud         , Cud         , Cud         , Cud         , Ur          , Uu          , Cud         , Uu          , Uu          , Ur          , Ur          , Uu          , Ur          
Xuc         , Xuc         , Xuc         , Xuc         , Ur          , Ur          , Uu^Vud      , Cud         , Ur          , Uu^Vud      , Ur          , Cud         , Ur          , Cud         , Ur          , Uu          , Ur          , Uu          , Uu          , Uu          , Uu^Vud      , Uu^Vud      , Xuc         , Xuc         
Xuc         , Xuc         , Uu^Uf       , Xuc         , Uu          , Uu^Vud      , Ur          , Cud         , 3 Kud       , Uu          , Uu          , Uu          , Uu          , Ur          , Uu          , Ur          , Uu          , Ur          , Uu          , Ur          , Xuc         , Xuc         , Xuc         , Xuc         
Xuc         , Xuc         , Ur          , Ur          , Uu          , Ur          , Uu          , Cud         , Cud         , Ur          , Uu          , Cud         , Cud         , Uu          , 4 Kud       , Cud         , Uu          , Uu^Vud      , Ur          , Ur          , Xuc         , Uu^Vud      , Uu^Vud      , Xuc         
Xuc         , Xuc         , Xuc         , Uu^Vud      , Uu          , Ur          , Uh          , Uu          , Ur          , Ur          , Uu^Vud      , Uu          , Cud         , Cud         , Cud         , Cud         , Uu          , Uu^Vud      , Xuc         , Xuc         , Uu^Vud      , Uu^Vud      , Ur          , Xu          
Xuc         , Xuc         , Xuc         , Ur          , Ur          , Uu^Vud      , Uh          , Uu          , Uu          , Uu^Vud      , Uh          , Uu          , Ur          , Uu^Vud      , Wwf         , Uu^Vud      , Ur          , Uu          , Uu          , Xuc         , Xuc         , Uu^Vud      , Uu          , Ur          
Xuc         , Xuc         , Xuc         , Ur          , Uu          , Uh          , Uu          , Ur          , Ur          , Uh          , Uu          , Wwf         , Wwf         , Wwf         , 5 Wwf       , Wwf         , Uu          , Ur          , Uu          , Uu          , Uu          , Uu          , Uu          , Ur          
Xuc         , Xuc         , Uu          , Uu^Vud      , Uu          , Ur          , Ur          , Uu          , Ur          , Uu^Vud      , Uh          , Wwf         , Wwf         , Wwf         , Wwf         , Wwf         , Xuc         , Uu          , Uu          , Ur          , Ur          , Ur          , Uu          , Uu          
Uu          , Uh          , Ur          , Ur          , Uu^Uf       , Uu          , Ur          , Uh          , Uu          , Uu          , Ur          , Uh          , Wwf         , 6 Wwf       , Wwf         , Wwf         , Xuc         , Uu          , Ur          , Uu          , Uu          , Uu          , Ur          , Ur          
Uu          , Uh          , Ur          , Uh          , Uu          , Uu^Uf       , Uu^Uf       , Uh          , Uu^Uf       , Ur          , Uu^Uf       , Ur          , Wwf         , Wwf         , Ur          , Uu          , Xuc         , Uu^Vud      , Xuc         , Xu          , Xuc         , Uu^Vud      , Xuc         , Xuc         
Uu          , Uu          , Uh          , Uh          , Uu          , Uu          , Uh          , Uu          , Uu          , Uu^Uf       , Uu          , Uu          , Wwf         , Wwf         , Uu          , Ur          , Xuc         , Xuc         , Xuc         , Xuc         , Xuc         , Xuc         , Xuc         , Xuc         
