border_size=1
usage=map

Ha, Tyb, Tyb, Tyb, Aa, Aa, Tyb, Tyb, Tyb, Tyb, Aa, Aa, Aa, Aa, Aa, Aa, Aa, Aa, Ha, Aa^Fma, Ha, Aa^Fma, Ha, Aa^Fma, Ha, Aa^Fma, Aa^Fma, Ha, Ha, Aa^Fma, Ha, Aa^Fma, Aa^Fma, Aa^Fma, Ha, Ha, Ha, Aa^Fma, Ha, Aa^Fma, Aa, Aa, Aa, Aa, Aa, Aa
Ms, Ha, Ha, Tyb, Tyb, Aa, Aa, Aa, Aa, Tyb, Tyb, Aa, Aa, Aa, Aa, Aa, Aa, Aa, Aa, Ha, Ha, Ha, Aa^Fma, Ha, Ha, Ha, Ha, Ha, Ha, Ha, Ha, Ha, Ha, Ha, Ha, Ha, Ha, Ha, Ha, Aa^Fma, Aa^Fma, Aa, Tyb, Aa, Aa, Aa
Ms, Ms, Ms, Ha, Ha, Aa, Aa, Aa, Aa, Tyb, Aa, Aa, Aa, Aa, Tyb, Aa, Aa, Aa, Aa, Ha, Ha, Aa^Fma, Aa^Fma, Aa^Fma, Ha, Ha, Ha, Aa^Fma, Ha, Ha, Aa^Fma, Ha, Aa^Fma, Ha, Ha, Ha, Aa^Fma, Ha, Aa^Fma, Ha, Tyb, Tyb, Tyb, Aa, Aa^Fma, Aa
Ha, Ms, Ms, Ms, Ha, Aa, Tyb, Tyb, Aa, Aa, Tyb, Aa, Aa^Fma, Tyb, Aa^Fma, Aa, Aa, Aa, Tyb, Aa, Aa, Ha, Aa, Ha, Aa^Fma, Ha, Aa^Fma, Ha, Ha, Ha, Aa^Fma, Ha, Ha, Ha, Ha, Ha, Aa^Fma, Ha, Aa^Fma, Tyb, Cea, Cea, Cea, Aa^Fma, Tyb, Aa
Ms, Ha, Ha, Ms, Aa, Aa, Aa, Tyb, Tyb, Aa, Tyb, Aa^Fma, Tyb, Tyb, Aa^Fma, Tyb, Aa^Fma, Aa^Fma, Tyb, Tyb, Aa^Fma, Aa, Aa, Ha, Ha, Aa^Fma, Ha, Ha, Aa^Fma, Ha, Ha, Aa^Fma, Aa, Aa, Aa, Ha, Aa, Ha, Aa, Tyb, Cea, 4 Kea, Cea, Aa^Fma, Tyb, Aa
Ms, Ms, Ms, Aa^Vha, Ha, Aa, Aa, Aa, Aa, Tyb, Aa, Aa^Fma, Aa, Aa, Tyb, Tyb, Tyb, Aa^Fma, Aa, Tyb, Aa^Fma, Aa, Aa, Aa, Aa, Aa, Ha, Aa^Fma, Aa, Ha, Ha, Ha, Aa, Ha, Ha, Aa, Tyb, Aa^Fma, Aa^Fma, Aa, Tyb, Cea, Tyb, Tyb, Tyb, Aa
Ms, Ms, Ms, Ha, Ms, Ha, Aa, Aa, Aa, Aa, Aa, Tyb, Tyb, Tyb, Tyb, Tyb, Tyb, Aa, Aa^Fma, Tyb, Tyb, Aa^Fma, Aa, Tyb, Tyb, Aa, Aa, Aa, Aa^Fma, Aa^Fma, Aa^Fma, Aa, Aa^Vha, Ha, Aa, Aa^Fma, Tyb, Tyb, Tyb, Aa, Tyb, Tyb, Tyb, Aa^Vha, Aa, Aa
Ms, Ms, Ms, Ms, Ms, Aa, Aa, Ha, Ha, Aa, Aa, Aa, Aa, Tyb, Aa^Fma, Tyb, Aa^Fma, Aa, Aa^Vha, Aa^Fma, Aa, Aa, Aa, Tyb, Tyb, Aa, Tyb, Aa, Tyb, Tyb, Tyb, Tyb, Tyb, Aa, Aa, Tyb, Aa^Fma, Tyb, Aa, Aa, Aa, Tyb, Aa, Aa, Ai, Aa
Ha, Ms, Ha, Ms, Ha, Ha, Ha, Ms, Ms, Ha, Aa, Aa, Aa, Aa, Aa, Aa^Fma, Aa, Tyb, Tyb, Tyb, Aa, Aa, Aa, Aa, Tyb, Tyb, Aa^Fma, Aa^Fma, Aa, Aa, Aa^Fma, Tyb, Aa^Fma, Tyb, Aa, Aa, Aa, Aa, Ai, Ai, Ai, Ai, Ai, Ai, Wo, Ai
Ms, Ha, Ms, Aa^Fma, Tyb, Ha, Ha, Ms, Ms, Ms, Ha, Aa, Ha, Aa, Aa, Aa, Aa, Tyb, Aa^Fma, Aa^Fma, Aa^Fma, Aa, Tyb, Aa, Aa, Tyb, Aa^Fma, Tyb, Tyb, Aa, Aa, Aa^Fma, Aa, Aa, Aa, Aa, Ai, Ai, Ai, Ai, Wo, Ai, Wo, Wo, Wo, Wo
Ms, Ms, Ms, Ms, Ms, Tyb, Aa, Aa, Aa, Tyb, Tyb, Ha, Tyb, Ha, Ha, Aa, Aa, Tyb, Aa, Tyb, Tyb, Tyb, Aa^Fma, Aa, Aa, Aa, Aa, Tyb, Aa, Aa, Aa^Vha, Aa, Aa, Aa, Ai, Ai, Ai, Ai, Wo, Wo, Wo, Wo, Wo, Wo, Wo, Wo
Ha, Ms, Ms, Ms, Aa^Vha, Ha, Aa, Ha, Ha, Ha, Aa, Tyb, Ha, Ms, Ms, Ha, Ha, Aa, Aa, Aa, Aa, Aa^Fma, Aa^Fma, Tyb, Tyb, Aa, Aa, Aa, Aa, Aa, Aa, Aa, Ai, Ai, Ai, Ai, Wo, Wo, Wo, Wo, Ww, Wo, Wo, Wo, Ww, Ww
Ha, Ha, Aa^Vha, Ha, Aa, Aa, Tyb, Ha, Ha, Aa, Ha, Ha, Aa^Fma, Ms, Ms, Ms, Aa, Ha, Ha, Aa, Aa, Aa, Tyb, Tyb, Aa, Aa, Ai, Ai, Ai, Ai, Ai, Ai, Wo, Wo, Wo, Wo, Wo, Wo, Ww, Ww, Ds, Ww, Ww, Ww, Hd, Ds
Aa, Ha, Ha, Aa, Cea, Cea, Cea, Tyb, Tyb, Tyb, Tyb, Ha, Ha, Ha, Tyb, Ha, Aa, Aa, Ha, Aa, Ha, Aa, Aa, Aa, Ai, Ai, Ai, Ai, Ai, Ai, Wo, Wo, Wo, Wo, Wo, Wo, Ww, Ww, Ds, Hd, Hd, Ds, Ds, Hd, Hd, Ds
Aa, Aa, Aa, Aa, Cea, 3 Kea, Cea, Ha, Aa, Ha, Ms, Aa, Aa^Vha, Tyb, Aa^Fma, Ha, Ms, Ha, Aa, Aa, Ha, Ha, Ai, Ai, Ai, Ai, Wo, Wo, Wo, Wo, Wo, Wo, Wo, Wo, Ww, Ww, Hd, Ds, Hd, Hd, Ds, Hd, Ds, Ds, Hd, Ds
Ha, Aa, Ha, Ha, Ha, Cea, Ha, Aa, Ms, Ms, Ms, Ms, Ha, Ha, Ms, Ha, Ms, Ms, Aa, Ha, Ai, Ai, Ai, Ai, Ai, Wo, Wo, Wo, Wo, Wo, Ww, Wo, Ww, Ww, Hd, Ds, Hd, Ds, Hd, Hd, Hd, Ds, Hd, Hd, Ds, Ds
Ha, Ha, Ms, Aa, Aa, Aa, Ha, Ha, Ms, Ms, Ms, Ms, Aa^Fma, Ms, Ms, Ms, Ms, Ha, Ai, Ai, Ai, Ai, Ai, Ai, Ai, Wo, Ww, Wo, Ww, Ww, Hd, Ww, Hd, Ds, Ds, Hd, Ds, Ds, Hd, Ds, Ds, Ds, Ds, Hd, Hd, Ds
Ms, Ha, Ms, Ms, Ha, Ha, Ha, Ha, Aa, Aa, Aa, Ha, Ha, Ms, Ms, Ha, Ai, Ai, Ai, Ai, Ai, Ai, Ai, Ai, Ai, Ai, Hd, Ww, Ds, Ds, Ds, Ds, Hd, Ds, Ds, Hd, Hd, Hd, Hd, Hd, Hd, Hd, Ds, Ds, Hd, Hd
Ha, Ms, Ms, Ms, Ms, Aa, Aa, Aa, Ha, Ha, Aa, Ha, Ha, Ha, Aa, Aa, Ai, Ai, Ai, Ai, Ai, Ai, Ai, Ai, Aa, Ha, Hd, Ds, Ds, Hd, Hd, Ds, Ds, Hd, Ds, Hd, Ds, Ds, Ds, Ds, Hd, Hd, Ds, Hd, Hd, Hd
Ha, Ha, Ms, Ms, Ha, Ms, Aa, Ha, Ai, Ha, Ai, Ai, Ai, Ai, Ai, Ai, Ai, Ai, Ai, Ai, Ai, Ai, Aa, Aa, Aa, Ha, Ha, Hd, Hd, Ds, Hd, Ds, Ds, Hd, Hd, Ds, Ds, Hd, Ds, Hd, Hd, Ds, Hd, Ds, Hd, Hd
Ha, Ha, Aa, Aa, Ai, Ha, Ai, Ai, Ai, Ai, Wo, Ai, Ai, Ai, Ai, Ai, Ai, Ai, Ai, Ai, Aa, Aa, Aa, Aa, Aa, Ha, Gs, Gs, Gs, Gs, Gs, Ds, Hd, Ds, Ds, Ds, Hd, Ds, Hd, Ds, Ds, Hd, Hd, Hd, Ds, Ds
Ha, Aa, Ai, Ai, Ai, Ai, Wo, Wo, Wo, Wo, Wo, Wo, Ai, Ai, Ai, Ai, Ai, Ai, Ai, Ai, Aa, Aa, Aa, Ha, Gg, Gg, Gs, Gs, Gs^Ft, Gs^Ft, Gs^Ft, Gs, Gs, Hd, Gs, Hd, Gs, Hd, Gs, Hd, Hd, Ds, Ds, Hd, Hd, Ds
Ai, Ai, Wo, Ai, Wo, Wo, Wo, Wo, Wo, Wo, Wo, Wo, Ai, Ai, Ai, Ai, Ai, Ai, Aa, Aa, Aa, Aa, Ha, Ha, Gg, Gg, Gs, Gs^Ft, Gs^Ft, Gs^Ft, Gs^Ft, Gs^Ft, Gs, Gs, Gs, Gs, Gs^Ft, Gs, Gs, Gs, Gs, Hd, Hd, Hd, Ds, Ds
Wo, Wo, Wo, Wo, Wo, Wo, Ai, Wo, Ai, Ai, Ai, Ai, Ai, Ai, Aa, Ai, Ha, Aa, Aa, Aa, Aa, Aa, Gg, Gg, Gg, Gg, Aa, Gs, Gs, Gs^Ft, Gs^Ft, Gs^Ft, Gs, Gs, Gs^Ft, Gs^Ft, Gs^Ft, Gs^Ft, Gs, Gs, Gs, Hd, Ds, Hd, Ds, Ds
Wo, Wo, Wo, Wo, Ai, Ai, Ai, Ai, Aa, Ai, Aa, Aa, Aa, Aa, Aa, Aa, Ha, Ha, Gg, Gg, Gg, Gg, Aa, Gg, Gg, Gg, Gg, Aa, Aa, Gs, Gs, Gs, Gs, Gs, Gs^Ft, Gs^Ft, Gs^Ft, Gs^Ft, Gs, Gs, Gs, Hd, Hd, Hd, Hd, Ds
Ww, Ww, Ai, Ai, Aa, Aa, Aa, Aa, Aa, Aa, Aa, Aa, Aa, Aa, Aa, Aa, Gg, Gg, Gg, Gg, Gg, Aa, Aa, Gg, Aa, Aa, Gg, Aa, Gg, Gg, Aa, Gg, Re^Vct, Gs, Gs^Ft, Gs^Ft, Gs^Ft, Gs, Gs, Gs, Gs, Hd, Hd, Ds, Hd, Ds
Aa, Ai, Aa, Aa, Aa, Aa, Aa, Aa, Aa, Aa, Aa^Fpa, Ha, Ha, Ha, Gg, Gg, Gg, Gg, Re^Vct, Re^Vct, Gg, Gg, Gg, Gg, Gg, Aa, Gg, Gg, Gg, Aa, Aa, Re^Vct, Re^Vct, Re^Vct, Gs, Gs^Ft, Gs, Gs, Gs, Gs, Gs^Ft, Gs, Gs, Hd, Gs, Hd
Aa, Aa, Aa, Aa, Aa, Ha, Ha, Ha, Aa^Fpa, Aa^Fpa, Aa^Fpa, Aa, Aa, Gg, Gg, Aa, Aa, Re^Vct, Gg, Gg, Ce, Ce, Ce, Gg, Aa, Aa, Gg, Gg, Gg, Gg, Ce, Gg, Gg, Aa, Aa, Gs, Gg, Gg, Aa, Gs^Ft, Gs^Ft, Gs^Ft, Gs^Ft, Gs, Gs, Gs
Ha, Aa, Ha, Aa, Aa^Fpa, Aa^Fpa, Gd, Aa^Fpa, Aa^Fpa, Aa^Fpa, Aa^Fpa, Aa^Fpa, Gll^Fp, Gg, Gg, Aa, Aa, Gg, Ce, Ce, 1 Ke, Ce, Ce, Aa, Aa, Gg, Aa, Aa, Gg, Ce, Ce, Ce, Ce, Aa, Aa, Gg, Gg, Gg, Aa, Gs^Ft, Gs^Ft, Gs^Ft, Gs^Ft, Gs^Ft, Gs, Gs
Gd, Ha, Aa^Fpa, Aa^Fpa, Gd, Gs^Fms, Gd, Aa^Fpa, Gd, Gs^Fms, Gll^Fp, Gs^Fms, Gs^Fms, Gll^Fp, Gg, Gg, Gg, Gg, Ce, Ce, Ce, Ce, Gg, Aa, Gg, Gg, Aa, Aa, Gg, Ce, Ce, 2 Ke, Ce, Ce, Gg, Gg, Aa, Gg, Gg, Aa, Aa, Gg, Aa, Gg, Gg, Gs
Gd, Aa^Fpa, Gll^Fp, Aa^Fpa, Gd, Gll^Fp, Gll^Fp, Gll^Fp, Gd, Gll^Fp, Gs^Fms, Gs^Fms, Gll^Fp, Gg, Aa, Gg, Gg, Gg, Gg, Ce, Gg, Gg, Aa^Vct, Aa^Vct, Aa, Gg, Aa, Aa, Gg, Gg, Gg, Ce, Ce, Ce, Gg, Gg, Aa, Aa, Aa, Gg, Gg, Aa, Gg, Gg, Gg, Gg
Gd, Gll^Fp, Gll^Fp, Gll^Fp, Gd, Gll^Fp, Gll^Fp, Gs^Fms, Gll^Fp, Gll^Fp, Gll^Fp, Gll^Fp, Aa, Aa, Aa, Aa, Aa, Gg, Aa, Gg, Gg, Aa^Vct, Gg, Aa, Gg, Gg, Gg, Aa, Gg, Re^Vct, Re^Vct, Gg, Aa, Gg, Gg, Aa, Aa, Aa, Gg, Gg, Gg, Gg, Gg, Aa, Gg, Gg
Gg, Gd, Gg, Gll^Fp, Gs^Fms, Gd, Gll^Fp, Gs^Fms, Aa, Gll^Fp, Gg, Gg, Gg, Aa, Aa, Aa, Gg, Aa, Gg, Aa, Gg, Gg, Aa, Gg, Aa, Aa, Aa, Gg, Gg, Re^Vct, Re^Vct, Gg, Aa, Aa, Aa, Gg, Gg, Gg, Aa, Gg, Aa, Gg, Aa, Aa, Gg, Gg
Gg, Gg, Gg, Gg, Gg, Gg, Gg, Aa, Aa, Gg, Gg, Gg, Aa, Gg, Gg, Gg, Gg, Gg, Gg, Aa, Gg, Aa, Gg, Gg, Gg, Aa, Aa, Gg, Gg, Gg, Gg, Gg, Gg, Aa, Gg, Gg, Gg, Gg, Aa, Gg, Gg, Aa, Gg, Gg, Gg, Gg
Gg, Gg, Gg, Gg, Gg, Gg, Gg, Aa, Gg, Gg, Gg, Aa, Gg, Aa, Gg, Gg, Gg, Gg, Gg, Gg, Gg, Gg, Gg, Gg, Gg, Gg, Gg, Aa, Gg, Gg, Gg, Gg, Gg, Gg, Gg, Aa, Aa, Aa, Gg, Gg, Gg, Gg, Gg, Gg, Gg, Gg
