border_size=1
usage=map

Aa          , Ha          , Ha          , Aa          , Aa          , Aa          , Aa          , Aa          , Aa          , Aa          , Aa          , Aa          , Aa          , Aa          , Aa          , Ha          , Ha          , Aa          , Ha          , Aa          , Aa          , Aa          , Aa          , Ha          , Ha          , Ha          , Ha          , Aa          , Aa          , Aa          , Ha          , Aa          
Aa          , Ha          , Ha^Cov      , Aa          , Ha          , Aa          , Aa          , Ha          , Aa          , Aa          , Aa          , Aa          , Aa^Fda      , Aa          , Aa          , Aa          , Ha          , Ha          , Ms          , Aa          , Aa          , Aa^Fda      , Aa^Fda      , Ha          , Aa^Fda      , Aa          , Ha          , Aa          , Aa^Fda      , Aa          , Ha          , Aa          
Aa          , Aa^Cov      , Aa^Kov      , Aa^Cov      , Aa          , Aa          , Ms^Xm       , Ha          , Ha          , Aa          , Aa          , Aa^Fda      , Ha          , Aa^Fda      , Aa^Fda      , Ha          , Ms          , Ms^Xm       , Ms          , Ha          , Aa          , Aa          , Ha          , Aa^Fda      , Ms          , Ms^Xm       , Ms          , Ha          , Aa^Fda      , Aa          , Ha          , Aa          
Aa          , Aa^Cov      , Aa^Cov      , Aa^Cov      , Ha          , Ms          , Ms          , Ms          , Ha          , Aa          , Aa          , Ha          , Aa^Vha      , Aa^Fda      , Aa          , Aa          , Aa          , Ms          , Aa          , Aa          , Aa          , Ha          , Aa^Vha      , Ha          , Aa          , Ms          , Aa^Fda      , Aa^Fda      , Ha          , Ha          , Aa          , Aa          
Aa          , Aa          , Ha          , Ha          , Aa^Fda      , Aa^Fda      , Aa^Fda      , Ha          , Aa          , Aa          , Aa          , Ha          , Ha          , Aa          , Aa          , Ha          , Ms          , Aa^Fda      , Ha          , Aa^Fda      , Aa          , Aa          , Aa          , Aa          , Ha^Cov      , Aa^Cov      , Aa^Cov      , Aa          , Aa          , Aa^Vha      , Aa          , Aa          
Aa          , Aa          , Ha          , Ha          , Ha          , Aa^Fda      , Aa          , Aa          , Aa          , Aa          , Ha          , Ha          , Ha          , Aa          , Ms          , Ha          , Ms          , Ms^Xm       , Ms          , Aa          , Aa^Fda      , Aa^Fda      , Ha          , Ha          , Aa^Cov      , Ha^Kov      , Aa^Cov      , Ha          , Aa^Fda      , Aa          , Aa          , Aa          
Aa          , Aa          , Aa          , Aa^Vha      , Aa          , Ha          , Aa          , Aa          , Aa          , Aa^Fda      , Aa^Fda      , Aa^Fda      , Aa          , Aa          , Ai          , Ms          , Ms          , Ms          , Ai          , Ai          , Ms          , Ms^Xm       , Ms          , Aa          , Ha          , Aa^Cov      , Aa          , Aa^Fda      , Aa          , Aa          , Aa          , Aa          
Aa          , Aa          , Aa          , Aa          , Aa          , Aa          , Aa          , Ha          , Ha          , Aa          , Ms^Xm       , Ms          , Ai          , Ai          , Ai          , Ai          , Ai          , Ai          , Ai          , Ai          , Ai          , Ms          , Ai          , Aa          , Aa          , Aa          , Ha          , Ha          , Aa          , Ha          , Aa          , Aa          
Aa          , Aa          , Ms          , Ha          , Ha          , Aa^Fda      , Aa^Fda      , Aa          , Ha          , Ms          , Ms          , Ms          , Ai          , Ai          , Ai          , Ai          , Ai          , Ai          , Ai          , Ai          , Ai          , Ai          , Ai          , Ai          , Ms          , Ms          , Ms          , Ha          , Ha          , Ha          , Ms          , Aa          
Ms^Xm       , Ms^Xm       , Ms^Xm       , Ms          , Ms^Xm       , Ms^Xm       , Ms^Xm       , Ms          , Ms          , Ms          , Ai          , Ai          , Ai          , Ai          , Ai          , Ai          , Aa          , Aa          , Ai          , Ai          , Ai          , Ai          , Ai          , Ai          , Ai          , Ms          , Ms          , Ms          , Ms^Xm       , Ms          , Ms^Xm       , Ms^Xm       
Ms          , Ms          , Ha          , Ms^Xm       , Ms          , Ms          , Ms          , Ms^Xm       , Ms^Xm       , Ms          , Ai          , Ai          , Ai          , Ai          , Ai          , Ai          , Aa          , Aa          , Aa          , Ai          , Ai          , Ai          , Ai          , Ai          , Ai          , Ms          , Ms^Xm       , Ms^Xm       , Ms          , Ms^Xm       , Ms          , Ms          
Aa          , Aa          , Aa^Fda      , Aa^Fda      , Aa          , Aa          , Aa          , Ms          , Ms          , Ms^Xm       , Ms^Xm       , Ai          , Ai          , Ai          , Ai          , Ai          , Ai          , Ai          , Ai          , Ai          , Ai          , Ai          , Ai          , Ai          , Ai          , Ms^Xm       , Ms          , Ms          , Aa          , Aa          , Aa          , Ms          
Aa          , Aa          , Ha          , Ha          , Ha          , Aa^Fda      , Aa^Fda      , Aa          , Aa          , Ms          , Ms^Xm       , Ai          , Ai          , Ai          , Ai          , Ai          , Ai          , Ai          , Ai          , Ai          , Ai          , Ai          , Ai          , Ai          , Ms^Xm       , Ms^Xm       , Ha          , Aa^Vha      , Ha          , Aa^Fda      , Aa^Fda      , Aa          
Aa          , Aa          , Ha          , Aa^Fda      , Ha          , Aa^Fda      , Aa^Fda      , Aa          , Ha          , Ha          , Aa          , Ai          , Ai          , Ai          , Ai          , Ai          , Ai          , Ai          , Ai          , Ai          , Ai          , Ai          , Ai          , Ai          , Aa          , Aa          , Ha          , Ha          , Aa          , Ha          , Aa^Fda      , Aa          
Aa          , Aa          , Aa          , Ha          , Ha          , Ha          , Aa          , Aa          , Aa          , Aa          , Aa          , Aa          , Ha          , Ha          , Ms          , Ms^Xm       , Ms^Xm       , Ai          , Ai          , Ai          , Ms^Xm       , Ai          , Ms^Xm       , Ms^Xm       , Aa          , Aa          , Aa          , Ha          , Ha          , Aa          , Aa          , Aa          
Aa          , Aa          , Aa          , Aa          , Aa^Fda      , Aa^Fda      , Aa^Fda      , Aa          , Aa^Fda      , Aa^Fda      , Aa          , Aa          , Aa          , Ha          , Ha          , Ms          , Ms          , Ms^Xm       , Aa^Fda      , Aa^Fda      , Ms          , Ms^Xm       , Ms          , Ms          , Aa          , Aa          , Aa          , Aa^Fda      , Ms          , Ha          , Aa          , Aa          
Ha          , Aa          , Aa          , Aa          , Aa^Fda      , Ha          , Ha          , Ha          , Ha          , Aa          , Aa^Fda      , Aa          , Aa          , Aa^Fda      , Aa^Fda      , Aa^Fda      , Aa          , Aa          , Aa          , Aa          , Ha          , Aa          , Aa          , Aa          , Ha          , Ha          , Aa^Fda      , Ms          , Ms          , Ms          , Aa          , Aa          
Ha          , Ha          , Ha          , Aa          , Aa^Fda      , Ha          , Ha          , Ha          , Aa^Fda      , Ha          , Ha          , Aa^Fda      , Aa          , Aa          , Ha          , Aa          , Aa          , Aa          , Ha          , Ha          , Ha          , Aa^Vha      , Aa          , Ha          , Ha          , Aa          , Aa          , Ha          , Aa          , Aa          , Aa          , Aa          
Aa          , Aa          , Aa          , Aa          , Aa          , Aa          , Aa^Fda      , Aa^Fda      , Aa          , Aa^Fda      , Aa          , Ha          , Aa          , Ha          , Aa          , Ha          , Aa          , Aa          , Aa          , Ha          , Aa          , Ha          , Ha          , Aa          , Aa          , Ha          , Aa          , Ha          , Aa          , Aa          , Aa          , Aa          
Aa          , Aa          , Aa          , Aa          , Ha          , Aa          , Ha          , Aa          , Aa          , Aa          , Aa          , Aa          , Ha          , Aa          , Aa          , Aa          , Ha          , Ha          , Ha          , Aa          , Aa          , Aa          , Aa          , Aa          , Aa          , Aa          , Aa          , Aa          , Aa          , Aa          , Aa          , Aa          
Aa          , Aa          , Aa^Fda      , Ha          , Aa          , Aa          , Aa^Vha      , Ha          , Aa^Fda      , Aa          , Aa          , Aa          , Aa^Fda      , Ha          , Ms          , Aa          , Aa          , Ha          , Aa          , Aa          , Ha          , Aa          , Aa          , Aa          , Aa          , Aa          , Ha          , Ha          , Ha          , Aa          , Aa          , Aa          
Aa          , Aa          , Aa^Fda      , Ha          , Ha          , Ha          , Ha          , Ha          , Ha          , Aa^Fda      , Aa          , Aa          , Aa^Fda      , Ms          , Ms          , Ha          , Aa          , Aa          , Ha          , Ha          , Ms          , Ha          , Ha          , Aa          , Aa          , Aa          , Aa          , Aa^Fda      , Aa^Fda      , Ha          , Aa          , Aa          
Aa          , Aa          , Aa          , Aa^Fda      , Aa          , Ha          , Ha          , Aa          , Aa          , Aa^Fda      , Aa          , Aa          , Ha          , Ha          , Ha          , Aa          , Aa          , Aa          , Aa          , Aa          , Ms          , Ms          , Ms          , Ha          , Ha          , Aa          , Aa          , Ha          , Aa^Fda      , Ha          , Aa          , Aa          
Aa          , Aa          , Aa          , Aa          , Aa^Fda      , Aa          , Aa          , Aa          , Aa          , Aa          , Aa          , Aa          , Aa          , Aa          , Aa          , Aa^Fda      , Aa          , Aa          , Aa^Fda      , Aa^Fda      , Ha          , Ms          , Aa          , Aa          , Aa          , Aa          , Aa          , Ha          , Aa          , Ha          , Aa          , Aa          
Aa          , Aa          , Aa          , Ha          , Ha          , Aa^Fda      , Aa          , Ha          , Ha          , Aa          , Aa          , Aa          , Aa^Fda      , Aa^Fda      , Aa          , Aa^Fda      , Ha          , Aa          , Aa          , Aa^Fda      , Aa          , Ha          , Aa          , Ha          , Ha          , Aa          , Ms          , Ha          , Aa          , Ha          , Aa          , Aa          
Aa          , Aa          , Aa          , Aa          , Ms          , Ms          , Ha          , Aa          , Aa          , Ha          , Aa^Fda      , Aa          , Aa          , Aa^Fda      , Ha          , Aa          , Aa          , Ha          , Aa          , Ha          , Ha          , Aa          , Aa^Fda      , Aa          , Aa          , Aa          , Ms          , Ms          , Ms          , Aa          , Aa          , Aa          
Aa          , Aa          , Aa^Fda      , Aa^Fda      , Ha          , Ms          , Aa          , Aa          , Aa^Vha      , Ha          , Aa^Fda      , Aa          , Ms          , Ms          , Ms          , Aa          , Aa          , Ha          , Aa          , Ha          , Aa          , Aa^Fda      , Aa^Fda      , Aa          , Ha          , Ha          , Aa          , Ms          , Aa          , Aa          , Aa          , Aa          
Aa          , Aa^Fda      , Aa^Fda      , Ha          , Aa          , Aa          , Aa          , Ha          , Ha          , Aa^Fda      , Aa          , Ms          , Aa^Fda      , Ms          , Aa          , Aa          , Ha          , Aa^Fda      , Aa^Fda      , Aa          , Aa          , Aa^Fda      , Aa          , Ha          , Ha          , Aa          , Aa          , Ha          , Ha          , Aa          , Aa^Fda      , Aa          
Aa          , Aa          , Ha          , Ha          , Ha          , Aa^Fda      , Aa^Fda      , Aa          , Ha          , Ha          , Aa          , Aa          , Aa^Fda      , Aa          , Aa          , Aa^Fda      , Aa^Fda      , Ha          , Aa^Fda      , Ha          , Aa          , Aa          , Aa          , Aa          , Aa^Fda      , Aa^Fda      , Aa          , Aa          , Ha          , Aa^Fda      , Cea         , Aa          
Aa          , Aa          , Aa          , Aa          , Aa          , Aa^Fda      , Aa^Fda      , Aa          , Aa          , Aa          , Aa          , Aa          , Aa^Fda      , Aa          , Aa          , Aa          , Aa^Fda      , Aa          , Aa^Fda      , Aa          , Aa          , Aa          , Aa          , Aa^Fda      , Aa          , Aa          , Aa          , Aa^Fda      , Cea         , 1 Kea       , Cea         , Aa          
Aa          , Aa          , Aa          , Aa          , Aa          , Aa          , Aa          , Aa          , Aa          , Aa          , Aa          , Aa          , Aa          , Aa^Fda      , Aa          , Aa          , Aa          , Aa          , Aa          , Aa          , Aa          , Aa          , Aa          , Aa          , Aa          , Aa          , Aa          , Ha          , Ha          , Cea         , Ha          , Aa          
Aa          , Aa          , Aa          , Aa          , Aa          , Aa          , Aa          , Aa          , Aa          , Aa          , Aa          , Aa          , Aa          , Aa          , Aa          , Aa          , Aa          , Aa          , Aa          , Aa          , Aa          , Aa          , Aa          , Aa          , Aa          , Aa          , Aa          , Aa          , Aa          , Aa          , Aa          , Aa          
