border_size=1
usage=map

Aa, Ha, Ha, Aa, Aa, Tyb, Tyb, Tyb, Tyb, Aa, Aa, Tyb, Tyb, Aa, Aa, Ha, Ha, Aa, Ha, Aa, Aa, Aa, Aa, Ha, Ha, Ha, Ha, Tyb, Tyb, Aa, Ha, Aa
Aa, Ha, Ha^Cov, Aa, Ha, Aa, Tyb, Ha, Aa, Aa, Aa, Tyb, Aa^Fda, Aa, Aa, Aa, Ha, Ha, Ms, Tyb, Tyb, Aa^Fda, Aa^Fda, Ha, Aa^Fda, Aa, Ha, Tyb, Aa^Fda, Aa, Ha, Aa
Aa, Aa^Cov, 3 Aa^Kov, Aa^Cov, Aa, Aa, Ms^Xm, Ha, Ha, Aa, Aa, Aa^Fda, Ha, Aa^Fda, Aa^Fda, Ha, Ms, Ms^Xm, Ms, Ha, Aa, Tyb, Ha, Aa^Fda, Ms, Ms^Xm, Ms, Ha, Aa^Fda, Aa, Ha, Tyb
Aa, Aa^Cov, Aa^Cov, Aa^Cov, Ha, Ms, Ms, Ms, Ha, Aa, Aa, Ha, Aa^Vha, Aa^Fda, Tyb, Aa, Aa, Ms, Aa, Aa, Aa, Ha, Aa^Vha, Ha, Tyb, Ms, Aa^Fda, Aa^Fda, Ha, Ha, Tyb, Tyb
Aa, Tyb, Ha, Ha, Aa^Fda, Aa^Fda, Aa^Fda, Ha, Tyb, Aa, Aa, Ha, Ha, Aa, Tyb, Ha, Ms, Aa^Fda, Ha, Aa^Fda, Aa, Tyb, Tyb, Tyb, Ha^Cov, Aa^Cov, Aa^Cov, Aa, Aa, Aa^Vha, Aa, Aa
Aa, Tyb, Ha, Ha, Ha, Aa^Fda, Aa, Tyb, Aa, Tyb, Ha, Ha, Ha, Aa, Ms, Ha, Ms, Ms^Xm, Ms, Aa, Aa^Fda, Aa^Fda, Ha, Ha, Aa^Cov, 4 Ha^Kov, Aa^Cov, Ha, Aa^Fda, Aa, Aa, Aa
Aa, Tyb, Aa, Aa^Vha, Aa, Ha, Aa, Tyb, Aa, Aa^Fda, Aa^Fda, Aa^Fda, Tyb, Tyb, Ai, Ms, Ms, Ms, Ai, Ai, Ms, Ms^Xm, Ms, Aa, Ha, Aa^Cov, Aa, Aa^Fda, Tyb, Aa, Aa, Tyb
Tyb, Aa, Aa, Aa, Aa, Aa, Aa, Ha, Ha, Aa, Ms^Xm, Ms, Ai, Ai, Ai, Ai, Ai, Ai, Ai, Ai, Ai, Ms, Ai, Tyb, Tyb, Aa, Ha, Ha, Tyb, Ha, Aa, Tyb
Tyb, Tyb, Ms, Ha, Ha, Aa^Fda, Aa^Fda, Aa, Ha, Ms, Ms, Ms, Ai, Ai, Ai, Ai, Ai, Ai, Ai, Ai, Ai, Ai, Ai, Ai, Ms, Ms, Ms, Ha, Ha, Ha, Ms, Aa
Ms^Xm, Ms^Xm, Ms^Xm, Ms, Ms^Xm, Ms^Xm, Ms^Xm, Ms, Ms, Ms, Ai, Ai, Ai, Ai, Ai, Ai, 5 Aa^Sc, Aa, Ai, Ai, Ai, Ai, Ai, Ai, Ai, Ms, Ms, Ms, Ms^Xm, Ms, Ms^Xm, Ms^Xm
Ms, Ms, Ha, Ms^Xm, Ms, Ms, Ms, Ms^Xm, Ms^Xm, Ms, Ai, Ai, Ai, Ai, Ai, Ai, Aa, Aa, Aa, Ai, Ai, Ai, Ai, Ai, Ai, Ms, Ms^Xm, Ms^Xm, Ms, Ms^Xm, Ms, Ms
Aa, Tyb, Aa^Fda, Aa^Fda, Aa, Aa, Aa, Ms, Ms, Ms^Xm, Ms^Xm, Ai, Ai, Ai, Ai, Ai, Ai, Ai, Ai, Ai, Ai, Ai, Ai, Ai, Ai, Ms^Xm, Ms, Ms, Tyb, Tyb, Aa, Ms
Tyb, Tyb, Ha, Ha, Ha, Aa^Fda, Aa^Fda, Tyb, Tyb, Ms, Ms^Xm, Ai, Ai, Ai, Ai, Ai, Ai, Ai, Ai, Ai, Ai, Ai, Ai, Ai, Ms^Xm, Ms^Xm, Ha, Aa^Vha, Ha, Aa^Fda, Aa^Fda, Aa
Aa, Tyb, Ha, Aa^Fda, Ha, Aa^Fda, Aa^Fda, Tyb, Ha, Ha, Tyb, Ai, Ai, Ai, Ai, Ai, Ai, Ai, Ai, Ai, Ai, Ai, Ai, Ai, Tyb, Tyb, Ha, Ha, Aa, Ha, Aa^Fda, Aa
Aa, Aa, Aa, Ha, Ha, Ha, Aa, Aa, Aa, Tyb, Aa, Aa, Ha, Ha, Ms, Ms^Xm, Ms^Xm, Ai, Ai, Ai, Ms^Xm, Ai, Ms^Xm, Ms^Xm, Aa, Aa, Aa, Ha, Ha, Aa, Tyb, Aa
Tyb, Tyb, Aa, Aa, Aa^Fda, Aa^Fda, Aa^Fda, Aa, Aa^Fda, Aa^Fda, Tyb, Tyb, Aa, Ha, Ha, Ms, Ms, Ms^Xm, Aa^Fda, Aa^Fda, Ms, Ms^Xm, Ms, Ms, Aa, Aa, Aa, Aa^Fda, Ms, Ha, Tyb, Tyb
Ha, Tyb, Aa, Aa, Aa^Fda, Ha, Ha, Ha, Ha, Aa, Aa^Fda, Tyb, Tyb, Aa^Fda, Aa^Fda, Aa^Fda, Aa, Tyb, Tyb, Aa, Ha, Tyb, Tyb, Aa, Ha, Ha, Aa^Fda, Ms, Ms, Ms, Tyb, Tyb
Ha, Ha, Ha, Aa, Aa^Fda, Ha, Ha, Ha, Aa^Fda, Ha, Ha, Aa^Fda, Aa, Aa, Ha, Aa, Aa, Tyb, Ha, Ha, Ha, Aa^Vha, Tyb, Ha, Ha, Tyb, Tyb, Ha, Aa, Tyb, Aa, Tyb
Tyb, Tyb, Tyb, Aa, Aa, Aa, Aa^Fda, Aa^Fda, Aa, Aa^Fda, Aa, Ha, Aa, Ha, Aa, Ha, Aa, Aa, Aa, Ha, Tyb, Ha, Ha, Aa, Aa, Ha, Tyb, Ha, Aa, Tyb, Aa, Aa
Aa, Tyb, Aa, Aa, Ha, Tyb, Ha, Aa, Tyb, Tyb, Tyb, Aa, Ha, Aa, Tyb, Aa, Ha, Ha, Ha, Tyb, Aa, Tyb, Aa, Aa, Aa, Aa, Aa, Aa, Aa, Aa, Aa, Aa
Aa, Aa, Aa^Fda, Ha, Tyb, Tyb, Aa^Vha, Ha, Aa^Fda, Aa, Tyb, Aa, Aa^Fda, Ha, Ms, Tyb, Aa, Ha, Aa, Tyb, Ha, Aa, Aa, Aa, Tyb, Aa, Ha, Ha, Ha, Aa, Aa, Aa
Tyb, Aa, Aa^Fda, Ha, Ha, Ha, Ha, Ha, Ha, Aa^Fda, Tyb, Aa, Aa^Fda, Ms, Ms, Ha, Aa, Aa, Ha, Ha, Ms, Ha, Ha, Tyb, Tyb, Aa, Aa, Aa^Fda, Aa^Fda, Ha, Aa, Aa
Tyb, Tyb, Aa, Aa^Fda, Tyb, Ha, Ha, Tyb, Tyb, Aa^Fda, Aa, Aa, Ha, Ha, Ha, Aa, Aa, Aa, Aa, Aa, Ms, Ms, Ms, Ha, Ha, Aa, Aa, Ha, Aa^Fda, Ha, Aa, Aa
Aa, Aa, Aa, Tyb, Aa^Fda, Aa, Tyb, Tyb, Aa^Cov, Tyb, Aa, Aa, Tyb, Tyb, Tyb, Aa^Fda, Aa, Aa, Aa^Fda, Aa^Fda, Ha, Ms, Tyb, Aa, Aa, Aa, Tyb, Ha, Tyb, Ha, Tyb, Aa
Tyb, Aa, Aa, Ha, Ha, Aa^Fda, Aa, Ha^Cov, 2 Ha^Kov, Aa^Cov, Aa, Aa, Aa^Fda, Aa^Fda, Aa, Aa^Fda, Ha, Tyb, Tyb, Aa^Fda, Aa, Ha, Tyb, Ha, Ha, Tyb, Ms, Ha, Tyb, Ha, Aa, Tyb
Aa, Tyb, Tyb, Aa, Ms, Ms, Ha, Aa^Cov, Aa^Cov, Ha^Cov, Aa^Fda, Aa, Aa, Aa^Fda, Ha, Aa, Aa, Ha, Tyb, Ha, Ha, Aa, Aa^Fda, Tyb, Tyb, Tyb, Ms, Ms, Ms, Aa, Aa, Tyb
Aa, Aa, Aa^Fda, Aa^Fda, Ha, Ms, Aa, Aa, Aa^Vha, Ha, Aa^Fda, Aa, Ms, Ms, Ms, Tyb, Tyb, Ha, Aa, Ha, Tyb, Aa^Fda, Aa^Fda, Tyb, Ha, Ha, Aa, Ms, Tyb, Tyb, Aa, Tyb
Aa, Aa^Fda, Aa^Fda, Ha, Aa, Aa, Aa, Ha, Ha, Aa^Fda, Aa, Ms, Aa^Fda, Ms, Aa, Tyb, Ha, Aa^Fda, Aa^Fda, Tyb, Tyb, Aa^Fda, Aa, Ha, Ha, Aa, Tyb, Ha, Ha, Aa, Aa^Fda, Aa
Aa, Aa, Ha, Ha, Ha, Aa^Fda, Aa^Fda, Aa, Ha, Ha, Tyb, Tyb, Aa^Fda, Aa, Aa, Aa^Fda, Aa^Fda, Ha, Aa^Fda, Ha, Tyb, Aa, Aa, Aa, Aa^Fda, Aa^Fda, Aa, Tyb, Ha, Aa^Fda, Cea, Aa
Tyb, Aa, Aa, Tyb, Aa, Aa^Fda, Aa^Fda, Aa, Aa, Tyb, Aa, Aa, Aa^Fda, Aa, Aa, Aa, Aa^Fda, Aa, Aa^Fda, Tyb, Tyb, Tyb, Aa, Aa^Fda, Tyb, Tyb, Aa, Aa^Fda, Cea, 1 Kea, Cea, Aa
Tyb, Aa, Aa, Tyb, Tyb, Aa, Aa, Tyb, Tyb, Aa, Aa, Aa, Aa, Aa^Fda, Aa, Aa, Aa, Aa, Aa, Aa, Tyb, Tyb, Aa, Aa, Aa, Tyb, Aa, Ha, Ha, Cea, Ha, Aa
Tyb, Tyb, Aa, Aa, Aa, Aa, Aa, Aa, Aa, Aa, Aa, Aa, Aa, Aa, Aa, Tyb, Tyb, Aa, Aa, Aa, Aa, Aa, Aa, Aa, Tyb, Aa, Tyb, Tyb, Tyb, Aa, Aa, Tyb
