border_size=1
usage=map

Ms          , Ms          , Ms          , Ms          , Ms          , Ms          , Ms^Xm       , Ms          , Ms          , Ms          , Ms^Xm       , Ms          , Ms          , Ms^Xm       , Ms^Xm       , Ha          , Ms          , Ms^Xm       , Ms          , Ms          , Ms          , Ms          , Ms^Xm       , Ms          , Ms          , Ms          , Ms          , Ms^Xm       , Ms          , Ms          , Ms          , Ms          
Ms          , Ms          , Ms          , Ms          , Ms^Xm       , Ms          , Ms          , Ms          , Ms          , Ms          , Ms          , Ms          , Ms          , Ms^Xm       , Ms          , Ha          , Ms          , Ms^Xm       , Ms^Xm       , Ms          , Ms          , Ms          , Ms          , Ms          , Ms^Xm       , Ms          , Ms          , Ms          , Ms          , Ms^Xm       , Ms          , Ms          
Ms          , Ms          , Ms          , Ms          , Ms          , Ms          , Ms          , Ms          , Ms          , Ms          , Ms^Xm       , Ms          , Ms^Xm       , Ms^Xm       , Ha          , Ms          , Ms^Xm       , Ms          , Ms          , Ms^Xm       , Ms^Xm       , Ms^Xm       , Ms^Xm       , Ms          , Ms          , Ms          , Ms          , Ms          , Ms          , Ms          , Ms          , Ms          
Ms          , Ms          , Ms^Xm       , Ms          , Ms          , Ms^Xm       , Ms          , Ms          , Ms          , Ms          , Ms          , Ms          , Ms^Xm       , Ms^Xm       , Ms          , Ms          , Ms          , Ms          , Ms          , Ms          , Ms          , Ms          , Ms          , Ms^Xm       , Ms^Xm       , Ms          , Ms^Xm       , Ms          , Ms          , Ms          , Ms          , Ms          
Ms          , Ms          , Ms^Xm       , Ms^Xm       , Ms^Xm       , Ms^Xm       , Ms^Xm       , Ms^Xm       , Ms^Xm       , Ms^Xm       , Ms^Xm       , Ms          , Ms^Xm       , Ms          , Ha          , Ha          , Ms          , Ms          , Ha          , Ha          , Ms          , Ms^Xm       , Ms          , Ms          , Ms          , Ms^Xm       , Ms          , Ms^Xm       , Ms^Xm       , Ms          , Ms          , Ms          
Ms^Xm       , Ms^Xm       , Ms          , Ms          , Ms          , Ms          , Ha          , Ms          , Ha          , Ms          , Ha          , Ms^Xm       , Ms          , Ms          , Aa          , Aa          , Aa^Fpa      , Ha          , Aa          , Ha          , Ha          , Ms          , Ms          , Ms          , Ha          , Ms          , Ms          , Ms          , Ms^Xm       , Ms          , Ms          , Ms          
Ms          , Ms          , Ms          , Ms^Xm       , Ms          , Ha          , Ha          , Ha          , Ha          , Ha          , Ha          , Ha          , Ha          , Ha          , Aa^Fma      , Aa^Fma      , Aa^Fma      , Aa^Fpa      , Aa          , Aa          , Aa          , Ha          , Aa          , Ha          , Aa          , Ha          , Ha          , Ms          , Ms          , Ms^Xm       , Ms^Xm       , Ms          
Ms          , Ms          , Ha          , Ms          , Ha          , Ha          , Ha          , Ha          , Ha          , Ha          , Ha          , Ha          , Aa          , Aa^Fpa      , Aa^Fma      , Ha          , Ha          , Aa^Fma      , Aa          , Aa          , Ha          , Aa          , Aa          , Aa          , Coa         , Aa          , Aa          , Ms          , Ms          , Ms          , Ms          , Ms^Xm       
Ha          , Ha          , Aa^Voa      , Ha          , Aa          , Aa          , Aa          , Aa^Fma      , Aa^Fma      , Ha          , Aa          , Aa          , Aa          , Aa^Fpa      , Aa^Fpa      , Ha          , Ha          , Aa^Fma      , Aa^Fpa      , Ha          , Aa^Voa      , Aa          , Aa          , Coa         , Koa         , Coa         , Aa          , Ha          , Ha          , Ms          , Ha          , Ms          
Aa          , Aa          , Aa          , Aa          , Coa         , Aa          , Ha          , Aa^Fpa      , Aa^Fpa      , Aa^Fma      , Aa          , Aa          , Ha          , Aa          , Aa          , Aa          , Aa          , Aa^Fpa      , Aa          , Ha          , Ha          , Ha          , Aa          , Coa         , Coa         , Coa         , Aa          , Aa^Fma      , Aa^Fpa      , Ha          , Aa          , Ha          
Ha          , Aa          , Ha          , Coa         , Koa         , Coa         , Ha          , Aa^Fpa      , Ha          , Aa          , Aa          , Ha          , Ha          , Ha          , Aa          , Aa          , Ha          , Aa          , Aa          , Aa^Fma      , Ha          , Ha          , Aa          , Aa          , Ha          , Aa          , Aa^Fpa      , Aa^Fma      , Aa^Fpa      , Aa          , Aa          , Aa          
Ha          , Ha          , Ha          , Coa         , Coa         , Coa         , Aa          , Ha          , Ha          , Aa          , Aa^Fma      , Aa^Fpa      , Aa^Fma      , Aa          , Aa          , Ha          , Ha          , Ha          , Aa^Fpa      , Aa^Fpa      , Aa^Fma      , Aa^Fpa      , Aa^Fma      , Aa          , Ha          , Ha          , Aa^Fpa      , Aa^Fma      , Ha          , Ha          , Aa          , Aa          
Ha          , Ha          , Ha          , Ha          , Ha          , Aa          , Aa          , Ha          , Aa          , Aa          , Aa          , Aa^Fma      , Aa^Fpa      , Aa^Fpa      , Aa          , Ha          , Ha          , Ha          , Ha          , Aa^Fma      , Aa^Fpa      , Aa^Fma      , Ha          , Ha          , Ha          , Ha          , Aa^Fma      , Aa^Fma      , Ha          , Ha          , Aa          , Aa          
Aa          , Aa          , Aa          , Ha          , Aa^Fma      , Aa          , Aa          , Aa          , Aa          , Aa          , Ha          , Ha          , Ha          , Ms          , Ms          , Aa          , Aa          , Ha          , Ha          , Ha          , Aa          , Ha          , Ha          , Ha          , Ms          , Aa^Fpa      , Aa^Fpa      , Ha          , Ha          , Ha          , Aa          , Aa          
Aa          , Aa          , Aa          , Aa^Fma      , Aa^Fpa      , Aa^Fma      , Ha          , Aa          , Aa^Fpa      , Aa^Fpa      , Aa^Fma      , Ha          , Ms          , Ms          , Ms          , Aa          , Aa^Fpa      , Aa          , Aa          , Aa          , Aa          , Aa          , Aa          , Ms          , Ms          , Ms          , Ha          , Aa          , Aa          , Aa          , Aa          , Aa          
Aa          , Aa          , Ha          , Aa^Fma      , Aa^Fma      , Ha          , Ha          , Ha          , Aa^Fpa      , Aa^Fma      , Aa^Voa      , Ha          , Aa^Fma      , Ms          , Ms          , Ha          , Ha          , Aa^Fpa      , Aa^Fpa      , Aa          , Ha          , Ha          , Ha          , Ms          , Ms          , Ms          , Ha          , Aa^Voa      , Ha          , Aa          , Aa          , Aa          
Ha          , Ha          , Ha          , Aa^Fpa      , Aa^Fma      , Aa^Fpa      , Ms          , Ms          , Ms          , Aa^Fma      , Aa^Fpa      , Aa^Fpa      , Ha          , Ms          , Ha          , Ha          , Aa          , Ha          , Aa          , Aa          , Ha          , Ha          , Aa^Fma      , Aa^Fma      , Aa^Fma      , Ha          , Ha          , Ha          , Ha          , Ha          , Ha          , Aa          
Ha          , Ha          , Ha          , Aa^Fma      , Aa^Fpa      , Aa^Fpa      , Ms          , Ms          , Ms          , Aa          , Aa          , Aa^Fpa      , Aa          , Ha          , Ha          , Ha          , Aa          , Aa          , Aa          , Aa          , Aa          , Ha          , Aa^Fpa      , Aa^Fpa      , Aa^Fma      , Ha          , Ha          , Ha          , Ha          , Ha          , Ha          , Aa          
Aa          , Ha          , Aa          , Aa^Fma      , Aa          , Ha          , Ha          , Ms          , Ha          , Aa          , Ha          , Ha          , Aa          , Aa          , Aa          , Aa          , Coa         , Coa         , Coa         , Aa          , Aa          , Aa          , Aa          , Aa^Fpa      , Aa          , Aa          , Ms          , Ms          , Ms          , Ha          , Aa^Fma      , Aa^Fma      
Aa          , Aa          , Aa          , Aa^Voa      , Aa          , Ha          , Ha          , Ha          , Aa          , Aa          , Ha          , Ha          , Aa          , Aa          , Aa^Voa      , Aa          , Coa         , Koa         , Coa         , Aa          , Aa          , Aa          , Aa^Fma      , Aa          , Aa          , Ha          , Ms          , Ms          , Ms          , Aa^Fpa      , Aa^Fma      , Aa^Fma      
Aa          , Aa          , Ha          , Aa          , Aa          , Aa          , Aa          , Aa          , Aa^Fma      , Aa          , Aa          , Aa          , Aa          , Aa          , Aa          , Aa          , Aa          , Coa         , Aa          , Aa          , Aa          , Aa^Fma      , Aa^Fpa      , Aa^Fpa      , Aa          , Aa^Voa      , Ha          , Ms          , Ha          , Ha          , Ha          , Aa^Fma      
Ms          , Ha          , Ha          , Ha          , Ha          , Aa          , Aa          , Aa^Fma      , Aa^Fma      , Aa^Fma      , Aa^Fma      , Aa          , Aa          , Aa          , Aa^Fma      , Aa          , Aa          , Aa          , Aa          , Aa          , Aa^Fpa      , Aa^Fma      , Aa^Fma      , Aa^Fpa      , Aa          , Aa          , Ha          , Ha          , Ha          , Ha          , Ms          , Ha          
Ms          , Ms          , Ms          , Ms          , Ha          , Aa          , Aa          , Aa^Fma      , Aa^Fma      , Aa^Fma      , Aa          , Aa          , Aa          , Aa          , Aa^Fpa      , Aa^Fma      , Aa^Fma      , Aa          , Aa          , Aa          , Aa^Fpa      , Aa^Fpa      , Aa^Fma      , Aa          , Ha          , Ha          , Ms          , Ms^Xm       , Ms          , Ms          , Ms^Xm       , Ms          
Ha          , Ms          , Ha          , Ha          , Ha          , Aa          , Aa          , Aa          , Aa          , Aa          , Aa          , Aa          , Aa          , Aa          , Aa^Fpa      , Aa^Fma      , Aa^Fma      , Aa          , Aa          , Aa          , Aa^Fma      , Aa^Fma      , Aa          , Aa          , Ha          , Ms          , Ms^Xm       , Ms^Xm       , Ms^Xm       , Ms^Xm       , Ms^Xm       , Ms          
Ha          , Ha          , Ha          , Ha          , Ha          , Ha          , Ha          , Ha          , Ha          , Aa          , Aa          , Aa^Voa      , Aa          , Aa          , Aa^Fpa      , Aa^Fpa      , Aa          , Aa          , Aa          , Aa          , Aa          , Aa          , Aa^Voa      , Aa          , Ha          , Ms^Xm       , Ai          , Ai          , Ai          , Ai          , Ai          , Ms^Xm       
Ha          , Ha          , Ha          , Ha          , Ms          , Ms          , Ms^Xm       , Ms^Xm       , Ai          , Ha          , Ai          , Aa          , Aa          , Aa          , Aa          , Aa          , Aa          , Aa          , Aa          , Aa          , Aa^Fpa      , Aa          , Aa          , Aa          , Aa          , Ha          , Ai          , Ai          , Wo          , Ai          , Ai          , Ms^Xm       
Ha          , Ha          , Ms          , Ms          , Ms          , Ms^Xm       , Ai          , Ai          , Wo          , Ai          , Wo          , Ai          , Ai          , Ha          , Ha          , Aa          , Aa          , Aa          , Aa^Fma      , Aa^Fpa      , Aa^Fpa      , Aa          , Ha          , Ha          , Ha          , Aa          , Ai          , Wo          , Wo          , Ai          , Ms^Xm       , Ms^Xm       
Ha          , Ha          , Ms          , Ms          , Ms^Xm       , Ms^Xm       , Ai          , Wo          , Wo          , Wo          , Wo          , Wo          , Wo          , Ai          , Ai          , Ha          , Aa          , Aa^Fma      , Aa^Fma      , Aa^Fpa      , Aa          , Aa          , Ai          , Ai          , Ai          , Ai          , Ai          , Wo          , Ai          , Ai          , Ms^Xm       , Ms^Xm       
Ms          , Ms          , Ms          , Ms          , Ms^Xm       , Ai          , Wo          , Wo          , Wo          , Wo          , Wo          , Wo          , Wo          , Wo          , Ai          , Ha          , Aa          , Aa          , Aa          , Aa^Fma      , Aa          , Ha          , Ai          , Ai          , Wo          , Wo          , Ai          , Ai          , Ms^Xm       , Ms          , Ms^Xm       , Ms          
Ms^Xm       , Ms^Xm       , Ms^Xm       , Ms          , Ms^Xm       , Ai          , Wo          , Wo          , Wo          , Wo          , Wo          , Wo          , Wo          , Wo          , Ai          , Ha          , Aa          , Aa          , Aa          , Aa          , Aa          , Ha          , Ha          , Ai          , Wo          , Wo          , Ai          , Ms          , Ms^Xm       , Ms^Xm       , Ms          , Ms          
Ms          , Ms          , Ms          , Ms^Xm       , Ms^Xm       , Ai          , Ai          , Wo          , Wo          , Wo          , Wo          , Wo          , Wo          , Wo          , Ai          , Aa          , Aa^Voa      , Aa          , Aa          , Aa          , Aa          , Aa          , Aa          , Ai          , Ai          , Ai          , Ms^Xm       , Ms^Xm       , Ms          , Ha          , Ha          , Ms          
Ha          , Ms          , Ha          , Ms          , Ms          , Ms^Xm       , Ms^Xm       , Ai          , Ai          , Wo          , Ai          , Wo          , Ai          , Ai          , Aa          , Aa          , Aa          , Aa          , Aa^Fma      , Aa^Fma      , Aa^Fma      , Aa          , Aa^Voa      , Aa          , Ha          , Ms^Xm       , Ha          , Ms          , Ha          , Ha          , Aa          , Ha          
Aa          , Ha          , Aa          , Ha          , Ha          , Ms          , Ha          , Ha          , Aa          , Ai          , Ha          , Ai          , Ha          , Ha          , Aa          , Aa          , Aa          , Aa^Fpa      , Aa^Fma      , Aa^Fpa      , Aa^Fma      , Aa          , Aa          , Aa          , Aa          , Ha          , Aa          , Ha          , Aa          , Aa          , Aa          , Aa          
Aa^Fpa      , Aa          , Aa^Fma      , Aa          , Aa          , Ha          , Aa          , Aa          , Aa^Fma      , Aa          , Aa          , Ha          , Aa          , Aa          , Aa          , Aa          , Aa          , Aa^Fpa      , Aa^Fpa      , Aa^Fma      , Aa^Fma      , Aa^Fpa      , Aa          , Aa          , Aa          , Aa          , Ms          , Aa          , Ms          , Aa          , Ms          , Aa          
Aa^Fpa      , Aa^Fma      , Aa          , Aa          , Ms^Xm       , Aa          , Ha          , Aa          , Aa          , Aa^Fma      , Aa          , Aa          , Aa          , Aa          , Aa^Fma      , Aa          , Aa          , Aa          , Aa^Fma      , Aa^Fma      , Aa^Fma      , Aa^Fpa      , Aa          , Aa          , Ms          , Ms          , Ms^Xm       , Ms          , Ms^Xm       , Ms          , Ms          , Ms          
Aa^Fpa      , Aa^Fpa      , Ha          , Ha          , Ms^Xm       , Ha          , Ha          , Ms^Xm       , Ms          , Ha          , Ha          , Aa          , Aa          , Aa^Fpa      , Aa^Fma      , Aa^Fma      , Aa          , Aa          , Aa          , Aa          , Aa          , Aa          , Aa          , Aa          , Ms^Xm       , Ms^Xm       , Aa^Voa      , Ms^Xm       , Ha          , Ms^Xm       , Ms^Xm       , Ms          
Aa          , Aa          , Ha          , Ms^Xm       , Aa          , Aa          , Aa          , Ms^Xm       , Ms^Xm       , Ms          , Ms          , Aa          , Aa          , Aa^Fma      , Aa^Fpa      , Aa^Fma      , Aa^Fma      , Aa          , Aa          , Aa          , Aa^Fma      , Aa          , Aa          , Aa          , Aa          , Aa          , Coa         , Coa         , Ha          , Ms          , Ms^Xm       , Ms          
Aa          , Aa          , Ms          , Ms^Xm       , Aa          , Aa          , Coa         , Aa          , Aa          , Ms^Xm       , Ms          , Ha          , Aa          , Aa^Fpa      , Aa^Fpa      , Aa^Fpa      , Aa          , Aa          , Aa^Fpa      , Aa^Fpa      , Aa^Fma      , Aa^Fma      , Aa          , Aa          , Aa          , Aa          , Coa         , Koa         , Coa         , Ha          , Ms^Xm       , Ms          
Aa          , Aa          , Ms          , Ms^Xm       , Ms^Xm       , Aa          , Aa          , Aa          , Ha          , Ms^Xm       , Ms          , Ha          , Aa          , Aa          , Aa          , Aa          , Aa^Voa      , Aa          , Aa^Fma      , Aa^Fma      , Aa^Fpa      , Aa^Fpa      , Aa          , Aa          , Ms          , Ha          , Ha          , Coa         , Ha          , Ha          , Ms^Xm       , Ms          
Aa          , Aa          , Ha          , Ms          , Ha          , Ms^Xm       , Ms^Xm       , Ms^Xm       , Ha          , Ms^Xm       , Ha          , Ha          , Aa          , Aa          , Aa^Fma      , Aa          , Aa          , Aa          , Aa          , Aa^Fma      , Aa^Fma      , Aa^Fma      , Aa          , Ms^Xm       , Ms^Xm       , Ms^Xm       , Ms^Xm       , Ms^Xm       , Ms^Xm       , Ms^Xm       , Ms          , Ms          
Aa          , Aa          , Aa          , Ha          , Aa          , Ha          , Ms          , Ha          , Ha          , Aa          , Aa          , Aa          , Aa^Fma      , Aa^Fpa      , Aa^Fma      , Aa^Fpa      , Aa          , Aa          , Aa          , Aa          , Aa          , Aa          , Aa          , Ms          , Ms          , Ms          , Ms          , Ms          , Ms          , Ms          , Ms          , Ms          
Aa          , Aa          , Aa          , Aa          , Aa^Fma      , Aa          , Aa          , Aa          , Aa          , Aa          , Aa          , Aa^Fpa      , Aa^Fma      , Aa^Fma      , Aa^Fpa      , Aa^Fpa      , Aa          , Aa          , Aa^Fma      , Aa          , Aa          , Aa          , Aa          , Aa          , Aa          , Ms          , Ms          , Ms          , Ms          , Ms          , Ms          , Ms          
Aa          , Aa          , Aa          , Aa^Fpa      , Aa^Fma      , Aa^Fma      , Aa^Fma      , Aa^Voa      , Aa^Fma      , Aa          , Aa          , Aa^Fpa      , Aa^Fma      , Aa^Fma      , Aa          , Aa          , Aa          , Aa^Fma      , Aa^Fma      , Aa^Fma      , Aa^Fma      , Aa          , Aa          , Aa          , Aa          , Aa          , Aa          , Aa          , Aa          , Aa          , Aa          , Aa          
Aa          , Aa          , Aa          , Aa^Fpa      , Aa^Fpa      , Aa^Fpa      , Aa          , Aa^Fma      , Aa          , Aa          , Aa          , Aa          , Aa          , Aa          , Aa          , Aa          , Aa          , Aa          , Aa^Fma      , Aa^Fpa      , Aa^Fma      , Aa          , Aa          , Aa          , Aa          , Aa          , Aa          , Aa          , Aa          , Aa          , Aa          , Aa          
Aa          , Aa          , Ha          , Ha          , Ha          , Aa          , Ha          , Aa          , Aa          , Aa          , Aa          , Aa          , Aa          , Aa          , Aa          , Aa          , Aa^Voa      , Aa          , Aa          , Aa^Fma      , Aa          , Aa          , Aa          , Aa          , Aa^Fma      , Aa          , Aa          , Aa          , Aa^Voa      , Aa          , Aa          , Aa          
Ha          , Ha          , Ms          , Ms^Xm       , Ms          , Ha          , Ms^Xm       , Ha          , Ha          , Aa          , Aa          , Aa          , Aa^Fma      , Aa^Fma      , Aa^Fma      , Aa          , Aa          , Aa          , Aa          , Aa          , Aa          , Aa          , Aa^Fpa      , Aa^Fma      , Aa          , Aa          , Aa          , Aa          , Aa          , Aa          , Aa          , Aa          
Ms          , Ms          , Ms          , Ms          , Ms^Xm       , Ms^Xm       , Ms          , Ms^Xm       , Ms^Xm       , Ha          , Aa          , Aa^Fma      , Aa^Fma      , Aa^Fpa      , Aa^Fma      , Aa          , Aa          , Aa          , Aa          , Aa          , Aa          , Aa^Fma      , Aa^Fma      , Aa^Fma      , Aa          , Aa          , Aa^Fpa      , Aa^Fpa      , Aa^Fpa      , Aa          , Aa          , Aa          
Ms          , Ms          , Ms^Xm       , Ms^Xm       , Ha          , Ha          , Ha          , Ms          , Ms^Xm       , Ha          , Aa          , Aa^Fma      , Aa          , Aa^Fma      , Aa          , Aa          , Aa          , Aa          , Aa          , Aa          , Aa          , Aa^Fpa      , Aa^Fma      , Aa^Fma      , Aa          , Aa          , Aa^Fpa      , Aa^Fma      , Aa^Fpa      , Aa          , Aa          , Aa          
Ms          , Ms^Xm       , Coa         , Coa         , Coa         , Ha          , Aa^Voa      , Ha          , Ha          , Ha          , Aa          , Aa          , Aa^Voa      , Aa          , Aa          , Aa          , Cea         , Cea         , Cea         , Aa          , Aa          , Aa^Fma      , Aa          , Aa          , Aa          , Aa          , Aa          , Aa^Fpa      , Aa^Fma      , Aa^Fma      , Aa          , Aa          
Ms^Xm       , Ms^Xm       , Coa         , Koa         , Coa         , Ha          , Ha          , Ha          , Ms^Xm       , Ha          , Ha          , Aa          , Aa          , Aa          , Aa          , Aa          , Cea         , Kea         , Cea         , Aa          , Aa          , Aa          , Aa^Voa      , Aa          , Aa          , Aa          , Aa          , Aa          , Aa          , Aa          , Aa          , Aa          
Ms          , Ms^Xm       , Ms^Xm       , Coa         , Ms^Xm       , Ms^Xm       , Ms^Xm       , Ms          , Ms^Xm       , Ms          , Ha          , Aa          , Aa          , Aa          , Aa          , Aa          , Aa          , Cea         , Aa          , Aa          , Aa          , Aa          , Aa          , Aa          , Aa          , Aa          , Aa          , Aa          , Aa          , Aa          , Aa          , Aa          
Ms          , Ms^Xm       , Ms          , Ms^Xm       , Ms          , Ms          , Ms          , Ms^Xm       , Ms          , Ms          , Ha          , Aa          , Aa          , Aa          , Aa          , Aa          , Aa          , Aa          , Aa          , Aa          , Aa          , Aa          , Aa          , Aa          , Aa          , Aa          , Aa          , Aa          , Aa          , Aa          , Aa          , Aa          
