border_size=1
usage=map

Hh, Hh, Mm, Mm, Mm, Mm, Mm, Mm, Mm, Mm, Mm, Mm^Xm, Mm^Xm, Mm, Hh, Hh, Hh, Gg, Gg, Gg, Gg, Gg, Gg, Gg, Gg, Gg, Gg, Gg, Gg, Gg, Gg, Gg, Rp, Rp, Rp, Gg, Gg, Gg, Gg, Gg, Gg, Gg, Gg, Gg, Gg, Gg, Gg, Gg, Gg, Gg, Gg, Gg, Ds, Ww, Ww, Wo, Wo, Wo, Wo, Wo, Wo, Wo
Mm, Mm, Mm^Xm, Mm^Xm, Mm, Mm, Mm^Xm, Mm, Mm, Mm^Xm, Mm^Xm, Mm, Mm, Mm^Xm, Mm, Hh, Hh, Gg, Gg, Gg, Gg, Gg, Gg, Gg, Gg, Gg, Gg, Gg, Gg, Gg, Gg, Gg, Rp, Rp, Rp, Gg, Gg, Gg, Gg, Gg, Gs^Vh, Gg, Gg, Gg, Gg, Gg, Gg^Eff, Gg, Gg, Gg, Gg, Gg, Gg, Ds, Ds, Ww, Wo, Wo, Wo, Wo, Wo, Wo
Mm, Mm^Xm, Mm, Mm, Hh, Mm, Mm, Mm^Xm, Mm^Xm, Mm, Mm, Mm^Xm, Mm, Mm, Mm^Xm, Hh, Hh, Hh, Hh, Gg, Gg, Gg, Gg, Gs^Vh, Gg, Gg, Gg, Gg, Gg^Eff, Gg^Eff, Gg^Eff, Gg, Gg, Rp, Rp, Rp, Gg, Gg, Gg, Gg, Gg, Gg, Gg, Gg, Gg^Eff, Gg^Eff, Rb^Gvs, Gg^Eff, Gg^Eff, Gg, Gg, Gs^Vh, Gg, Gg, Ds, Ww, Wo, Wo, Wo, Wo, Wo, Wo
Hh, Mm, Hh, Hh, Mm, Mm^Xm, Mm^Xm, Mm, Mm, Mm, Hh, Mm, Hh, Mm, Mm, Mm^Xm, Mm^Xm, Hh, Hh, Hh, Gg, Gg, Gg, Gg, Gg, Gg, Gg^Eff, Gg^Eff, Rb^Gvs, Rb^Gvs, Rb^Gvs, Gg^Eff, Gg^Eff, Rp, Rp, Rp, Rp, Gg, Gg, Gg, Gg, Gg, Gg^Eff, Gg^Eff, Rb^Gvs, Rb^Gvs, Rb^Gvs, Rb^Gvs, Rb^Gvs, Gg^Eff, Gg^Eff, Gg, Gg, Gg, Ds, Ww, Wo, Wo, Wo, Wo, Wo, Wo
Mm, Mm^Xm, Mm^Xm, Hh, Hh, Mm, Mm, Mm^Xm, Mm, Hh, Mm, Mm^Xm, Mm^Xm, Hh, Hh, Mm, Mm, Mm, Hh, Hh, Hh, Gg, Gg, Gg, Gg^Eff, Gg^Eff, Rb^Gvs, Rb^Gvs, Rb^Gvs, Rb^Gvs, Rb^Gvs, Rb^Gvs, Gg^Eff, Rp^Eff, Rp, Rp, Rp, Gg, Gg, Gg, Gg^Eff, Gg^Eff, Rb^Gvs, Rb^Gvs, Rb^Gvs, Rb^Gvs, Rb^Gvs, Rb^Gvs, Rb^Gvs, Rb^Gvs, Rb^Gvs, Gg^Eff, Gg^Eff, Gg, Gg, Ww, Ww, Wo, Wo, Wo, Wo, Wo
Hh, Mm, Mm, Mm^Xm, Mm, Mm, Mm, Mm, Mm, Mm^Xm, Mm, Mm, Mm, Mm^Xm, Mm, Hh, Mm^Xm, Mm^Xm, Mm, Hh, Gg, Gg, Gg^Eff, Gg^Eff, Rb^Gvs, Rb^Gvs, Rb^Gvs, Rb^Gvs, Rb^Gvs, Rb^Gvs, Gg^Eff, Gg^Eff, Gg, Gg, Rp, Rp, Rp, Rp, Gg, Gg, Gg, Gg^Eff, Gg^Eff, Rb^Gvs, Rb^Gvs, Rb^Gvs, Rb^Gvs, Rb^Gvs, Rb^Gvs, Rb^Gvs, Gg^Eff, Gg^Eff, Gg, Gg, Gg, Ds, Ww, Wo, Wo, Wo, Wo, Wo
Hh, Hh, Mm, Mm, Hh, Hh, Mm^Xm, Mm, Hh, Mm, Hh, Hh, Mm^Xm, Mm, Mm, Mm^Xm, Mm, Mm, Hh, Hh, Gg, Gg^Eff, Gg^Eff, Rb^Gvs, Rb^Gvs, Rb^Gvs, Rb^Gvs, Rb^Gvs, Gg^Eff, Gg^Eff, Gg^Eff, Gg, Gg, Gs^Vh, Gg, Rp, Rp, Rp, Gg, Gg, Gg, Gs^Vh, Gg, Gg^Eff, Gg^Eff, Rb^Gvs, Rb^Gvs, Rb^Gvs, Gg^Eff, Gg^Eff, Gg, Gg, Gg, Gs^Vh, Gg, Ds, Ww, Wo, Wo, Wo, Wo, Wo
Hh, Hh, Mm^Xm, Mm, Mm, Mm, Mm, Mm^Xm, Mm^Xm, Mm, Mm, Mm, Mm, Mm^Xm, Mm^Xm, Mm, Hh, Hh, Hh, Hh, Hh, Gg, Gg, Gg^Eff, Gg^Eff, Rb^Gvs, Gg^Eff, Gg^Eff, Rb^Gvs, Rb^Gvs, Rb^Gvs, Gg^Eff, Gg^Eff, Gg, Gg, Rp, Rp, Rp, Rp, Gg, Gg, Gg, Gg, Gg, Gg, Gg^Eff, Gg^Eff, Gg^Eff, Gg, Gg, Gg, Gg, Gg, Gg, Gg, Ds, Ww, Wo, Wo, Wo, Wo, Wo
Hh, Mm, Mm, Mm^Xm, Mm^Xm, Hh, Hh, Mm, Mm, Mm, Hh, Mm, Hh, Mm, Mm, Mm, Mm, Mm, Mm, Hh, Hh, Hh, Gg, Gs^Vh, Gg^Eff, Gg^Eff, Rb^Gvs, Rb^Gvs, Rb^Gvs, Rb^Gvs, Rb^Gvs, Rb^Gvs, Rb^Gvs, Gg^Eff, Gg^Eff, Rp, Rp, Rp, Rp, Gg, Gg, Gg, Cvj, Gg, Gg, Gg, Gg, Cvj, Cvj, Gg, Gg, Gg, Cvj, Gg, Gg, Ds, Ww, Wo, Wo, Wo, Wo, Wo
Mm, Mm^Xm, Mm^Xm, Mm, Mm, Mm, Mm^Xm, Hh, Hh, Hh, Hh, Hh, Hh, Hh, Hh, Hh, Mm, Mm, Mm, Mm, Hh, Hh, Gg^Eff, Gg^Eff, Rb^Gvs, Rb^Gvs, Rb^Gvs, Rb^Gvs, Rb^Gvs, Rb^Gvs, Rb^Gvs, Rb^Gvs, Gg^Eff, Gg^Eff, Gg, Gg, Rp, Rp, Rp, Gg, Gg, Cvj, Cvj, Cvj, Rr, Rr, Rr, Cvj, Rr, Rr, Rr, Cvj, Cvj, Cvj, Gg, Ds, Ds, Ww, Ww, Ww, Ww, Wo
Hh, Mm, Mm, Mm^Xm, Mm, Mm, Mm, Mm^Xm, Mm^Xm, Hh, Hh, Mm^Xm, Mm^Xm, Hh, Mm, Mm^Xm, Mm^Xm, Mm, Mm, Hh, Hh, Hh, Gg, Gg^Eff, Gg^Eff, Rb^Gvs, Rb^Gvs, Rb^Gvs, Rb^Gvs, Rb^Gvs, Gg^Eff, Gg^Eff, Gg, Gg, Gg, Gg, Cvj, Rp, Rr, Cvj, Cvj, Rr, Rr^Rhx, Rr^Rhx, Rr, Rr, Rr, Rr, Wwb, Rr^Rhx, Rr^Rhx, Wwb, Wwb, Rr, Rr, Gg, Cvj, Ds, Ww, Wo, Ww, Ww
Hh, Hh, Mm^Xm, Mm, Mm, Mm^Xm, Mm, Mm, Mm, Mm, Mm^Xm, Mm, Mm, Mm^Xm, Mm^Xm, Mm, Mm, Mm^Xm, Mm, Hh, Gg, Gg, Gg, Gg, Gg, Gg^Eff, Gg^Eff, Rb^Gvs, Gg^Eff, Gg^Eff, Gg, Gg, Gg, Gg, Cvj, Cvj, Cvj, Cvj, Rr, Rr, Rr, Rr, Rr, Rr, Rr^Rhx, Rr^Rhx, Wwb, Wwb^Bsb\, Wwb^Bsb\, Wwb, Wwb, Wwb, Wwb, Rr, Rr, Cvj, Cvj, Ww, Wo, Wo, Ww, Wo
Mm, Hh, Mm, Mm^Xm, Mm^Xm, Mm, Hh, Hh, Hh, Mm, Mm, Mm^Xm, Mm^Xm, Mm, Mm, Mm, Mm, Mm, Hh, Gg, Gg, Gg, Gg, Gs^Vh, Gg, Gg, Gg, Gg^Eff, Gg, Gg, Gg, Gg, Gg, Gg, Gg, Cvj, Rr, Rr, Rr, Rr^Vhc, Rr^Vhx, Rr^Rhx, Rr, Rr, Rr, Rr^Rhx, Wwb, Wwb, Cvj, Cvj, Cvj, Wwb, Wwb, Rr^Rhx, Rr, Rr, Ww, Ww, Ww, Ww, Ww, Wo
Hh, Mm, Mm, Mm, Mm, Mm^Xm, Mm^Xm, Hh, Mm, Mm^Xm, Mm^Xm, Mm, Mm, Mm, Mm^Xm, Mm, Mm, Mm, Hh, Chr, Chr, Gg, Gg, Gg, Gg, Gg, Gg, Gg, Gg, Gs^Vh, Gg, Gg, Gg, Gg, Rr, Rr, Rr^Rhx, Rr^Rhx, Rr, Rr, Rr, Rr, Wwb, Rr^Vhc, Rr^Vhx, Rr, Rr^Rhx, Wwb, Cvj, 6 Kvj, Cvj, Wwb, Rr^Rhx, Rr^Rhx, Rr, Rr^Vhc, Ww, Wo, Wo, Ww, Ww, Wo
Hh, Hh, Mm^Xm, Mm, Mm, Mm, Hh, Mm^Xm, Hh, Mm, Mm, Mm^Xm, Mm, Mm, Mm, Mm^Xm, Mm^Xm, Hh, Hh, Khr, Chr, Gg, Gg, Gg, Gg, Gg, Gg, Gg, Gg, Gg, Gg, Gg, Cvj, Cvj, Rr, Rr^Rhx, Rr, Rr, Wwb, Wwb, Wwb, Wwb, Wwb, Wwb, Wwb, Rr^Rhx, Wwb, Wwb, Rr, Cvj, Wwb, Wwb, Rr, Rr, Rr^Vhx, Rr^Rhx, Ww, Wo, Wo^Bw|, Wo, Ww, Wo
Hh, Mm, Mm, Mm^Xm, Mm^Xm, Mm, Hh, Hh, Mm^Xm, Hh, Hh, Mm, Mm^Xm, Mm, Mm, Mm, Mm, Mm, Hh, Chr, Gg, Gg, Gg, Gg, Gg, Gg, Gg, Gg, Gg, Gg, Gg, Gg, Cvj, Cvj, Rr, Rr, Rr^Vhc, Wwb, Wwb, Wwb, Wwb, Wwb, Wwb, Wwb, Wwb, Wwb, Wwb, Wwb, Rr, Rr, Rr, Rr, Rr, Rr^Rhx, Rr^Rhx, Ww, Wo, Ww, Wo^Bw/, Ww, Wo, Wo
Hh, Hh, Hh, Mm, Mm, Mm, Mm^Xm, Mm, Mm, Mm^Xm, Mm^Xm, Mm, Mm, Mm^Xm, Mm^Xm, Mm, Hh, Hh, Hh, Hh, Gg, Gg, Gg, Gg, Gg, Gg, Gg, Gg, Gg, Gg, Gg, Gg, Gg, Rr, Rr^Rhx, Rr^Vhx, Wwb, Wwb, Wwb, Wwb, Rr, Rr, Rr, Wwb, Wwb, Wwb, Wwb^Bsb/, Rr, Rr^Vhx, Wwb, Wwb, Rr^Rhx, Rr^Rhx, Rr, Rr, Ww, Wo^Bw/, Ww^Bw/, Ww, Ww^Bw\, Ww, Wo
Mm, Mm^Xm, Mm^Xm, Hh, Hh, Mm, Mm, Mm^Xm, Mm^Xm, Mm, Mm, Mm, Hh, Mm, Mm, Mm, Hh, Hh, Hh, Gg, Gg, Gg, Gs^Vh, Gg, Gg, Gg, Gg^Eff, Gg, Gg, Gs^Vh, Gg, Gg, Gg, Rr, Rr, Rr^Rhx, Wwb, Wwb, Wwb, Wwb, Wwb, Rr^Vhc, Rr^Vhx, Rr, Rr, Wwb^Bsb/, Wwb, Wwb, Wwb, Wwb, Wwb, Rr^Vhc, Rr, Rr, Rr, Ww^Bw/, Ww, Ww^Bw\, Wo, Ww, Ww, Wo
Hh, Mm, Mm, Mm^Xm, Mm, Hh, Mm^Xm, Mm, Mm, Mm, Mm, Mm^Xm, Mm^Xm, Hh, Hh, Mm, Mm, Hh, Hh, Hh, Gg, Gg, Gg, Gg, Gg^Eff, Gg^Eff, Rb^Gvs, Gg^Eff, Gg^Eff, Gg, Gg, Gg, Cvj, Cvj, Cvj, Rr, Rr, Wwb, Wwb, Wwb, Cvj, Wwb, Wwb, Rr, Rr^Rhx, Rr, Wwb, Wwb, Wwb, Wwb, Wwb, Rr, Rr, Rr^Rhx, Rr^Vhx, Rr, Ww, Wo, Wo, Ww, Wo, Wo
Hh, Hh, Hh, Mm, Hh, Mm, Mm, Mm^Xm, Mm^Xm, Hh, Mm, Mm, Mm, Mm^Xm, Mm, Mm, Mm, Mm, Hh, Hh, Gg, Gg, Gg^Eff, Gg^Eff, Rb^Gvs, Rb^Gvs, Rb^Gvs, Rb^Gvs, Rb^Gvs, Gg^Eff, Gg^Eff, Gg, Rp, Cvj, Rr, Rr, Rr^Rhx, Rr, Wwb^Bsb\, Cvj, 7 Kvj, Cvj, Wwb^Bsb\, Rr, Rr^Vhc, Wwb, Wwb, Wwb, Wwb, Wwb, Cvj, Cvj, Cvj, Rr, Rr^Rhx, Rr^Rhx, Ww, Ww, Ww^Bw/, Ww, Wo, Wo
Hh, Hh, Mm, Hh, Mm^Xm, Hh, Hh, Mm, Mm, Mm, Hh, Mm, Mm, Mm, Hh, Hh, Hh, Mm, Hh, Hh, Gg^Eff, Gg^Eff, Rb^Gvs, Rb^Gvs, Rb^Gvs, Rb^Gvs, Rb^Gvs, Rb^Gvs, Rb^Gvs, Rb^Gvs, Gg^Eff, Gg^Eff, Rr, Rr, Wwb, Rr^Vhx, Wwb, Wwb, Wwb, Cvj, Cvj, Cvj, Wwb, Rr, Rr, Wwb, Wwb, Wwb, Wwb, Wwb, Cvj, 8 Kvj, Cvj, Rr, Rr, Ww, Ww^Bw/, Wo^Bw/, Wo, Ww^Bw\, Ww, Wo
Mm, Mm, Hh, Mm, Mm, Mm^Xm, Mm^Xm, Hh, Hh, Hh, Mm, Mm^Xm, Mm^Xm, Hh, Hh, Hh, Hh, Hh, Gg, Gg^Eff, Gg^Eff, Rb^Gvs, Rb^Gvs, Rb^Gvs, Rb^Gvs, Rb^Gvs, Rb^Gvs, Rb^Gvs, Gg^Eff, Gg^Eff, Rp, Rp, Rr, Wwb, Wwb, Wwb, Wwb, Wwb, Wwb, Wwb, Wwb^Bsb|, Wwb, Wwb, Rr^Vhx, Rr^Rhx, Rr, Rr, Rr, Rr, Wwb^Bsb/, Wwb, Cvj, Rr, Rr, Rr, Ww^Bw/, Ww, Wo^Bw\, Ww, Ww, Ww, Wo
Mm, Mm, Mm, Hh, Mm, Mm, Mm, Mm, Mm^Xm, Hh, Hh, Mm, Mm, Mm^Xm, Mm, Hh, Hh, Gg, Gs^Vh, Gg, Gg, Gg^Eff, Gg^Eff, Rb^Gvs, Rb^Gvs, Rb^Gvs, Gg^Eff, Gg^Eff, Gg, Gg, Rp, Rp, Cvj, Cvj, Cvj, Wwb, Rr, Rr, Rr, Wwb, Rr, Wwb, Wwb, Wwb, Rr, Rr, Rr^Vhc, Rr^Vhx, Rr^Rhx, Wwb, Wwb, Wwb, Rr^Rhx, Rr^Rhx, Rr, Rr, Ww, Ww, Wo, Wo, Wo, Ww
Mm, Mm^Xm, Mm^Xm, Mm, Hh, Mm, Mm, Mm, Mm, Mm, Mm, Mm^Xm, Mm, Mm, Hh, Hh, Hh, Gg, Gg, Gg, Gg^Eff, Gg^Eff, Rb^Gvs, Gg^Eff, Gg^Eff, Gg^Eff, Gs^Vh, Gg, Gg, Gg, Rp, Rp, Gll^Fp, Cvj, Gll^Fp, Rr, Cvj, Rr^Rhx, Rr^Rhx, Rr, Rr, Rr, Wwb, Wwb, Rr^Rhx, Rr, Rr, Rr^Rhx, Rr, Rr, Rr, Rr, Rr, Rr, Cvj, Cvj, Ww, Wo, Wo, Wo, Wo, Wo
Hh, Mm, Mm, Mm^Xm, Mm, Hh, Hh, Hh, Mm, Mm, Mm, Mm, Mm^Xm, Hh, Hh, Hh, Gg, Gg, Gg^Eff, Gg^Eff, Rb^Gvs, Rb^Gvs, Rb^Gvs, Rb^Gvs, Rb^Gvs, Gg^Eff, Gg^Eff, Gg, Gg, Rp, Rp, Rp, Gg, Gll^Fp, Gg, Gg, Cvj, Cvj, Cvj, Rr, Cvj, Cvj, Cvj, Wwb, Cvj, Cvj, Rr, Rr, Cvj, Cvj, Cvj, Rr, Gg, Cvj, Cvj, Cvj, Ww, Wo, Wo, Wo, Wo, Wo
Hh, Hh, Mm^Xm, Mm, Hh, Hh, Mm^Xm, Mm, Mm, Mm, Mm^Xm, Mm^Xm, Mm, Mm, Hh, Gg, Gg^Eff, Gg^Eff, Rb^Gvs, Rb^Gvs, Rb^Gvs, Rb^Gvs, Rb^Gvs, Rb^Gvs, Rb^Gvs, Rb^Gvs, Rb^Gvs, Gg^Eff, Gg^Eff, Rp, Rp, Gll^Fp, Gll^Fp, Gg, Gll^Fp, Gg, Gll^Fp, Cvj, Gg, Gg, Cvj, Cvj, Gg, Cvj, Cvj, Cvj, Gg, Gg, Gg, Cvj, Gg, Gg, Gg, Ds, Ww, Ww, Wo, Wo, Wo, Wo, Wo, Wo
Hh, Mm, Mm, Mm^Xm, Mm^Xm, Mm, Mm, Mm^Xm, Mm^Xm, Mm, Mm, Mm, Hh, Hh, Hh, Gg^Eff, Gg^Eff, Rb^Gvs, Rb^Gvs, Rb^Gvs, Rb^Gvs, Rb^Gvs, Rb^Gvs, Rb^Gvs, Rb^Gvs, Rb^Gvs, Gg^Eff, Gg^Eff, Rp, Rp, Rp, Gg, Gll^Fp, Gg, Gll^Fp, Gg, Ds, Ds, Ww, Ds, Ww, Ds, Ds, Gg, Gg, Gg, Ds, Gg, Ds, Gg, Ds, Gg, Ds, Ww, Wo, Wo, Wo, Wo, Wo, Wo, Wo, Wo
Hh, Hh, Hh, Mm, Mm, Mm, Mm^Xm, Mm, Mm, Mm, Hh, Hh, Mm, Hh, Hh, Gg, Hh, Gg^Eff, Gg^Eff, Rb^Gvs, Rb^Gvs, Rb^Gvs, Rb^Gvs, Rb^Gvs, Gg^Eff, Gg^Eff, Hh, Hh, Rp, Rp, Gll^Fp, Gg, Gg, Gg, Ds, Ds, Ww, Ww, Ww, Ww, Ww, Ww, Ww, Ds, Wwf, Ds, Wwf, Ds, Ww, Ww, Ww, Ds, Ww, Ww, Wo, Wo, Wo, Wo, Wo, Wo, Wo, Wo
Hh, Hh, Mm^Xm, Hh, Mm, Mm, Mm, Mm^Xm, Mm^Xm, Hh, Mm, Mm, Hh, Hh, Hh, Gg, Gg, Hh, Gg, Gg^Eff, Gg^Eff, Rb^Gvs, Gg^Eff, Gg^Eff, Gg, Gg, Hh, Hh, Rp, Rp, Gll^Fp, Gll^Fp, Gg, Gll^Fp, Ds, Ww, Wo, Wo, Wo, Ww, Wo, Wo, Wo, Ww, Wo, Wwf, Ww, Ww, Wo, Wo, Wo, Ww, Wo, Wo, Wo, Wo, Wo, Wo, Wo, Wo, Wo, Wo
Mm, Hh, Mm, Mm^Xm, Mm^Xm, Mm, Mm, Mm, Mm, Mm, Hh, Hh, Hh, Hh, Gg, Gg, Gg, Gg, Gg, Gg, Hh, Gg^Eff, Hh, Hh, Gg, Gg, Gg, Hh, Rp, Rp, Gg, Gg, Gll^Fp, Gll^Fp, Ds, Ww, Wo, Wo, Wo, Wo, Wo, Wo, Wo, Wo, Ww, Wwf, Wo, Wo, Ww, Wo, Wo, Wo, Wo, Wo, Wo, Wo, Wo, Wo, Wo, Wo, Wo, Wo
Hh, Mm, Mm, Mm, Mm, Mm^Xm, Mm, Hh, Mm, Mm^Xm, Mm, Hh, Hh, Gg, Gg, Hh, Hh, Hh, Gg, Gg, Hh, Hh, Hh, Hh, Hh, Gg, Gg, Gg, Rp, Rp, Gll^Fp, Gg, Ds, Ds, Ww, Ww, Wo, Wo, Wo, Wo, Wo, Wo, Ww, Ww, Gll^Fp, Wwf, Wwf, Ww, Gll^Fp, Ww, Ww, Wo, Wo, Wo, Wo, Wo, Wo, Wo, Wo, Wo, Wo, Wo
Hh, Hh, Mm, Mm, Hh, Mm, Hh, Hh, Hh, Mm, Hh, Hh, Hh, Gg, Gg, Hh, Hh, Hh, Gg, Gg, Gg, Hh, Gg, Hh, Gg, Gg, Hh, Hh, Rp, Rp, Gll^Fp, Gg, Ds, Ww, Wo, Wo, Wo, Wo, Wo, Wo, Wo, Ww, Gll^Fp, Gll^Fp, Rp, Rp, Rp, Gll^Fp, Gg^Ve, Gll^Fp, Ww, Wo, Wo, Wo, Wo, Wo, Wo, Wo, Wo, Wo, Wo, Wo
Hh, Mm, Mm^Xm, Mm^Xm, Mm, Hh, Hh, Hh, Hh, Hh, Hh, Hh, Gg, Gg, Gg, Gg, Gg, Gg, Gg, Gg, Hh, Gg, Gg, Gg, Gg, Gg, Rp, Rp, Rp, Rp, Gg, Gll^Fp, Ds, Ww, Wo, Wo, Wo, Wo, Wo, Wo, Wo, Ww, Gll^Fp, Gg^Fet, Gll^Fp, Gll^Fp, Gll^Fp, Rp, Gll^Fp, Gll^Fp, Ww, Wo, Wo, Wo, Wo, Wo, Wo, Wo, Wo, Wo, Wo, Wo
Mm, Mm^Xm, Mm, Mm, Hh, Hh, Hh, Hh, Gg, Hh, Gg, Gg, Gg, Gg, Hh, Gg, Gg, Gg, Hh, Hh, Hh, Hh, Gg, Gg, Rp, Rp, Rp, Rp, Gll^Fp, Gll^Fp, Gll^Fp, Gg, Gg, Ww, Ww, Wo, Wo, Wo, Wo, Wo, Wo, Ww, Ww, Gll^Fp, Ww, Gll^Fp, Wwf, Wwf, Ww, Ww, Wo, Wo, Wo, Wo, Wo, Wo, Wo, Wo, Wo, Wo, Wo, Wo
Hh, Mm, Hh, Hh, Hh, Hh, Gg, Gg, Re^Vct, Gg, Gg, Gg, Gg, Hh, Hh, Hh, Gg, Gg, Hh, Hh, Hh, Hh, Rp, Rp, Rp, Rp, Gll^Fp, Gg, Gg, Gg, Gg, Gg, Gll^Fp, Ds, Ww, Wo, Wo, Wo, Wo, Wo, Wo, Wo, Wo, Ww, Wo, Ww, Wwf, Wo, Wo, Wo, Wo, Wo, Wo, Wo, Wo, Wo, Wo, Wo, Wo, Wo, Wo, Wo
Hh, Hh, Hh, Hh, Gg, Gg, Gg, Gg, Gg, Gg, Gg, Re^Vct, Gg, Hh, Hh, Hh, Gg, Gg, Gg, Gg, Gg, Gg, Rp, Rp, Gg, Gll^Fp, Gll^Fp, Gg, Gll^Fp, Gll^Fp, Gg, Gll^Fp, Gll^Fp, Ds, Ww, Wo, Wo, Wo, Wo, Wo, Wo, Wo, Wo, Wo, Wo, Wo, Wo, Wwf, Wo, Wo, Wo, Wo, Ww, Ww, Ww, Ww, Ww, Wo, Wo, Wo, Wo, Wo
Hh, Hh, Gg, Gg, Gg, Gg, Ce, Gg^Vct, Ce, Gg^Vct, Ce, Gg, Gg, Gg, Gg, Gg, Gg, Gg, Gg, Gg, Gg, Gg, Rp, Rp, Gll^Fp, Gg, Gg, Gg, Gg, Gll^Fp, Gg, Gg, Ds, Ww, Ww, Wo, Wo, Wo, Wo, Wo, Wo, Wo, Wo, Wo, Wo, Wo, Ww, Wwf, Wwf, Ww, Ww, Ww, Cvj, Cvj, Ww, Ww, Ww, Ww, Wo, Wo, Wo, Wo
Gg, Gg, Gg, Re^Vct, Gg, Ce, Ce, Ce, 2 Ke, Ce, Ce, Ce, Gg, Gg, Gg, Gg, Hh, Hh, Hh, Hh, Gg, Gg, Rp, Rp, Gll^Fp, Gll^Fp, Gg, Gg, Gll^Fp, Gg, Gg, Gll^Fp, Ds, Ww, Ww, Wo, Wo, Wo, Wo, Wo, Wo, Wo, Ww, Ww, Ww, Ww, Ds, Cvj, Cvj, Cvj, Ds, Ds, Cvj, Cvj, Ww, Wo, Wo, Ww, Ww, Wo, Ww, Wo
Gg, Gg, Hh, Gg, Gg, Ce, Ce, Ce, Ce, Ce, Ce, Ce, Gg, Gg, Gg, Hh, Hh, Hh, Hh, Hh, Gg, Gg, Rp, Rp, Rp, Gll^Fp, Gg, Gll^Fp, Gll^Fp, Gg, Gg, Gll^Fp, Gll^Fp, Ds, Ww, Ww, Ww, Wo, Ww, Ww, Ww, Ww, Cvj, Cvj, Cvj, Ds, Rr, Cvj, Wwb, Cvj, Rr^Rhx, Rr, Ww, Ww, Ww, Wo, Wo, Ww, Wo, Ww, Wo, Ww
Hh, Hh, Hh, Hh, Gg, Gg, Gg, Gg^Vct, Gg, Gg^Vct, Gg, Gg, Gg, Gg, Gg, Hh, Gg, Gg, Gg, Gg, Gg, Gg, Gg, Rp, Rp, Rp, Rp, Gg, Gg, Gg, Gll^Fp, Gg, Gg, Gg, Ds, Ww, Ww, Ww, Ds, Ds, Ds, Cvj, Cvj, Rr, Rr, Rr, Wwb, Wwb, Wwb, Rr, Rr, Rr, Ww, Ww, Wo, Wo, Ww, Ww, Wo, Ww, Wo, Ww
Hh, Hh, Hh, Hh, Gg, Gg, Gg, Gg, Gg, Gg, Gg, Gg, Gg, Gg, Gg, Gg, Gg, Gg, Gg^Eff, Gg^Eff, Gg^Eff, Gg, Gg, Gg, Gg, Rp, Rp, Gll^Fp, Gg, Gll^Fp, Gll^Fp, Gll^Fp, Gg, Gg, Gll^Fp, Ds, Gll^Fp, Ds, Cvj, Rr, Rr, Rr, Rr, Rr, Rr, Wwb, Wwb, Wwb, Cvj, Cvj, Cvj, Rr, Rr^Vhx, Ww, Wo, Ww, Ww, Wo^Bw|, Wo, Ww, Ww, Ww
Hh, Hh, Hh, Gg, Gg, Gg, Ce^Vct, Gg, Ce, Gg, Ce^Vct, Gg, Gg, Re^Vct, Gg, Gg, Gg^Eff, Gg^Eff, Rb^Gvs, Rb^Gvs, Rb^Gvs, Gg^Eff, Gg^Eff, Gg, Gg, Rp, Rp, Gll^Fp, Gg, Gg, Gg, Gg, Gll^Fp, Gg, Gg, Gll^Fp, Rr, Rr, Cvj, Cvj, Wwb, Rr^Rhx, Rr^Rhx, Rr^Vhc, Rr, Wwb, Wwb, Rr, Cvj, 4 Kvj, Cvj, Rr, Rr^Rhx, Ww, Wo, Wo^Bw\, Ww^Bw/, Wo^Bw/, Wo^Bw\, Wo, Ww, Wo
Hh, Hh, Hh, Gg, Gg, Ce, Ce, Ce, 1 Ke, Ce, Ce, Ce, Gg, Gg, Gg^Eff, Gg^Eff, Rb^Gvs, Rb^Gvs, Rb^Gvs, Rb^Gvs, Rb^Gvs, Rb^Gvs, Rb^Gvs, Gg^Eff, Gg^Eff, Rp, Rp, Rp, Rp, Gll^Fp, Gg, Gll^Fp, Gll^Fp, Gg, Cvj, Cvj, Rr, Rr, Rr, Cvj, Wwb, Wwb, Wwb, Rr^Vhx, Rr, Wwb, Wwb^Bsb/, Rr, Wwb, Cvj, Rr, Rr, Rr^Rhx, Ww, Ww^Bw/, Wo^Bw/, Wo^Bw\, Ww, Ww, Wo, Ww, Wo
Hh, Hh, Gg, Gg, Gg, Ce, Ce^Vct, Ce, Ce, Ce, Ce^Vct, Ce, Gg^Eff, Gg^Eff, Rb^Gvs, Rb^Gvs, Rb^Gvs, Rb^Gvs, Rb^Gvs, Rb^Gvs, Rb^Gvs, Rb^Gvs, Gg^Eff, Gg^Eff, Gs^Vh, Gg, Gg, Rp, Rp, Gll^Fp, Gll^Fp, Gg, Gg, Gg, Cvj, Cvj, Rr, Rr^Vhc, Rr^Rhx, Rr, Rr, Wwb, Wwb, Rr^Rhx, Rr, Wwb^Bsb/, Wwb, Wwb, Wwb, Rr, Rr^Rhx, Rr^Vhx, Rr, Rr, Ww, Ww, Ww, Ww, Wo, Ww, Ww, Ww
Hh, Hh, Gg, Gg, Gg, Gg, Gg, Gg, Gg, Gg, Gg, Gg^Eff, Gg^Eff, Rb^Gvs, Rb^Gvs, Rb^Gvs, Rb^Gvs, Rb^Gvs, Rb^Gvs, Rb^Gvs, Gg^Eff, Gg^Eff, Rb^Gvs, Gg^Eff, Gg^Eff, Gg, Gg, Rp, Rp, Rp, Rp, Gg, Gll^Fp, Gll^Fp, Rr, Cvj, Rr, Rr, Rr, Rr, Wwb^Bsb\, Wwb, Wwb, Rr, Rr, Rr^Rhx, Wwb, Wwb, Wwb, Rr, Rr, Rr^Vhc, Rr, Rr^Rhx, Rr^Rhx, Ww, Wo, Ww, Wo, Ww^Bw|, Wo, Wo
Gg, Gg, Gg, Gg, Gg, Gg, Gg, Gg, Gg, Gg, Gg, Gg, Gg, Gg^Eff, Gg^Eff, Rb^Gvs, Rb^Gvs, Rb^Gvs, Gg^Eff, Gg^Eff, Rb^Gvs, Rb^Gvs, Rb^Gvs, Rb^Gvs, Rb^Gvs, Gg^Eff, Gg^Eff, Gg, Gg, Rp, Rp, Rp, Rp, Gll^Fp, Cvj, Rr, Rr^Rhx, Rr^Vhx, Rr^Rhx, Rr, Wwb, Wwb^Bsb\, Cvj, Cvj, Cvj, Wwb, Wwb, Wwb, Rr, Rr, Rr, Rr, Rr, Rr^Vhx, Rr^Rhx, Ww, Wo, Ww^Bw\, Ww^Bw/, Ww^Bw/, Wo^Bw\, Wo
Gg, Gg, Hh, Gg, Gg, Gg, Ce, Gg^Vct, Ce, Gg^Vct, Ce, Gg, Gg, Gg, Gg, Gg^Eff, Gg^Eff, Gg^Eff, Rb^Gvs, Rb^Gvs, Rb^Gvs, Rb^Gvs, Rb^Gvs, Rb^Gvs, Rb^Gvs, Rb^Gvs, Rb^Gvs, Gg^Eff, Gg^Eff, Gg, Gg, Rp, Rp, Cvj, Cvj, Wwb, Wwb, Rr^Rhx, Wwb, Wwb, Wwb, Wwb, Cvj, 5 Kvj, Cvj, Wwb, Wwb, Rr, Rr^Vhc, Rr^Rhx, Rr, Rr, Cvj, Rr, Rr, Ww, Ww^Bw/, Wo^Bw/, Ww^Bw\, Wo, Wo, Wo
Hh, Hh, Hh, Gg, Gg, Ce, Ce, Ce, 3 Ke, Ce, Ce, Ce, Gg, Gg, Gg^Eff, Gg^Eff, Rb^Gvs, Rb^Gvs, Rb^Gvs, Rb^Gvs, Rb^Gvs, Rb^Gvs, Rb^Gvs, Rb^Gvs, Rb^Gvs, Rb^Gvs, Rb^Gvs, Rb^Gvs, Rb^Gvs, Gg^Eff, Gg^Eff, Rp, Rp, Rp, Rr, Wwb, Wwb, Wwb, Wwb, Wwb, Rr, Wwb^Bsb/, Wwb, Cvj, Wwb^Bsb\, Wwb, Wwb, Wwb, Wwb, Wwb, Wwb, Cvj, 9 Kvj, Cvj, Rr, Rr, Ww, Ww, Ww, Wo, Wo, Wo
Hh, Hh, Hh, Gg, Gg, Ce, Ce, Ce, Ce, Ce, Ce, Ce, Gg, Gg^Eff, Gg^Eff, Rb^Gvs, Rb^Gvs, Rb^Gvs, Rb^Gvs, Rb^Gvs, Rb^Gvs, Rb^Gvs, Rb^Gvs, Rb^Gvs, Rb^Gvs, Rb^Gvs, Rb^Gvs, Rb^Gvs, Gg^Eff, Gg^Eff, Gg, Gg, Rp, Rp, Rp, Rr, Cvj, Wwb, Rr, Rr, Rr^Rhx, Wwb, Wwb, Wwb, Rr^Rhx, Rr, Rr^Vhc, Wwb, Wwb, Wwb, Rr, Cvj, Cvj, Cvj, Rr, Rr^Rhx, Ww, Wo, Wo, Ww, Wo, Wo
Hh, Hh, Hh, Gg, Gg^Vct, Gg, Gg, Gg^Vct, Gg, Gg^Vct, Gg, Gg, Hh, Hh, Gg, Gg^Eff, Gg^Eff, Rb^Gvs, Rb^Gvs, Rb^Gvs, Rb^Gvs, Rb^Gvs, Rb^Gvs, Rb^Gvs, Rb^Gvs, Rb^Gvs, Gg^Eff, Gg^Eff, Gg, Gg, Gg, Gg, Hh, Rp, Rp, Rp, Cvj, Cvj, Rr, Rr^Vhc, Rr, Rr, Wwb, Wwb, Wwb, Rr, Rr^Vhx, Wwb, Wwb, Rr^Rhx, Rr^Rhx, Rr, Rr, Rr, Rr^Vhc, Rr^Rhx, Ww, Wo, Ww, Ww, Wo, Wo
Gg, Hh, Gg, Hh, Hh, Gg, Re^Vct, Gg, Hh, Gg, Gg, Hh, Gg, Hh, Gg, Gg, Gg, Gg^Eff, Gg^Eff, Rb^Gvs, Rb^Gvs, Rb^Gvs, Rb^Gvs, Rb^Gvs, Gg^Eff, Gg^Eff, Gg, Hh, Hh, Hh, Gg, Gg, Hh, Hh, Rp, Rp, Rp, Rp, Rr, Rr, Cvj, Rr, Rr, Wwb, Wwb, Rr, Rr, Wwb, Wwb, Rr^Vhc, Rr, Rr, Rr, Rr^Rhx, Rr^Rhx, Rr^Vhx, Ww, Ww, Wo, Wo, Wo, Wo
Gg, Gg, Gg, Hh, Hh, Gg, Gg, Gg, Hh, Hh, Gg^Vct, Gg, Hh, Gg, Gg, Gg, Hh, Gg, Hh, Gg^Eff, Gg^Eff, Rb^Gvs, Gg^Eff, Gg^Eff, Gg, Gg, Gg, Hh, Gg, Gg, Gg, Gg, Hh, Hh, Gg, Rp, Rp, Rp, Gg, Cvj, Cvj, Cvj, Rr, Wwb, Wwb, Rr^Rhx, Rr, Wwb, Wwb, Rr, Cvj, Cvj, Cvj, Rr, Rr, Cvj, Cvj, Ww, Ww, Wo, Wo, Wo
Gll^Fp, Gg, Gg, Gg, Gg, Hh, Gg, Gg, Hh, Hh, Gg, Gg, Hh, Hh, Gg, Gg, Gg, Hh, Hh, Hh, Gg, Gg^Eff, Gg, Gg, Hh, Gg, Gg, Gg, Ds, Ds, Ds, Hh, Hh, Gg, Gg, Hh, Hh, Hh, Gg, Gg, Gg, Rr, Rr, Rr, Cvj, Cvj, Rr, Cvj, Cvj, Rr, Gg, Cvj, Cvj, Rr, Gg, Cvj, Cvj, Cvj, Ww, Wo, Wo, Wo
Ss, Gll^Fp, Hh, Gg, Gg, Gg, Gg, Gg, Gg, Gg, Gg, Hh, Gg, Hh, Hh, Gg, Hh, Gg, Gg, Hh, Gg, Gg, Gg, Hh, Hh, Hh, Gg, Gg, Ss, Ss, Ss, Hh, Gg, Gg, Hh, Hh, Gg, Gg, Gll^Fp, Ds, Ds, Gg, Gg, Gg, Gg, Cvj, Gg, Cvj, Gg, Gg, Gg, Gg, Gs, Gg, Gll^Fp, Gg, Gll^Fp, Gll^Fp, Ww, Wo, Wo, Wo
Ss, Ss, Gll^Fp, Hh, Hh, Gg, Gs^Vh, Gg, Hh, Gg, Gg, Gg, Hh, Gg, Gg, Gg, Gg, Hh, Gg, Gg, Gll^Fp, Gll^Fp, Gll^Fp, Gg, Gs, Gg, Ds, Gll^Fp, Gll^Fp, Ss, Gll^Fp, Gg, Gg, Gg, Gg, Hh, Gll^Fp, Gll^Fp, Ss, Ss, Ds, Gg, Gg, Gg, Gg, Gg, Gs, Gg, Ds, Ds, Ss, Gs, Gs, Gll^Fp, Ds, Ds, Ss, Gll^Fp, Ww, Wo, Wo, Wo
Ss, Ss, Ss, Gll^Fp, Gll^Fp, Gg, Gg, Gg, Hh, Hh, Gg, Gg, Hh, Hh, Gg, Gs^Vh, Ds, Ds, Ds, Gs, Gs, Ss, Ss, Gs, Ds, Ds, Ss, Gll^Fp, Ss, Ss, Gll^Fp, Gg, Ss, Ss, Gs, Gs, Ds, Ss, Ss, Gll^Fp, Gll^Fp, Gg, Ss, Gll^Fp, Gll^Fp, Gs, Gll^Fp, Gs, Ds, Ss, Gll^Fp, Ss, Ss, Gs, Ds, Ss, Ss, Ss, Gll^Fp, Ww, Ww, Wo
Ss, Ss, Ds, Ds, Gll^Fp, Gg, Ds, Ds, Ds, Hh, Gg, Hh, Ss, Gll^Fp, Gll^Fp, Gg, Ss, Ss, Ss, Gs, Gg, Ss, Ss, Gs, Ds, Ss, Ss, Ss, Ss, Ss, Ds, Gs, Gll^Fp, Ss, Gll^Fp, Gs, Gg, Ds, Gg, Gll^Fp, Ds, Ds, Ss, Ss, Ss, Ss, Ss, Gll^Fp, Gs, Gs, Ds, Gll^Fp, Ss, Gll^Fp, Gs, Ss, Ss, Ss, Gll^Fp, Gll^Fp, Ds, Ww
Gs, Gs, Gll^Fp, Ds, Gs, Gs, Gll^Fp, Gll^Fp, Ss, Ds, Gs, Ss, Ss, Ss, Gll^Fp, Gs, Ss, Ss, Gll^Fp, Gll^Fp, Gg, Ss, Gg, Gs, Gs^Vh, Ss, Gll^Fp, Gll^Fp, Gll^Fp, Ds, Gs, Gs, Gll^Fp, Ss, Ss, Gll^Fp, Gs, Gs, Gll^Fp, Gg, Gg, Ds, Gs, Ss, Ss, Ss, Ss, Ss, Gs, Ds, Ss, Ss, Ss, Gll^Fp, Ds, Gs, Gg, Gs^Vh, Gs, Gs, Gs, Ds
Gs, Gll^Fp, Ss, Ss, Ds, Gs, Ss, Ss, Ss, Gll^Fp, Gs, Ss, Ss, Ss, Ds, Gs, Gs, Ss, Gll^Fp, Gll^Fp, Gg, Gs, Gg, Gg, Gs, Gs, Ds, Gll^Fp, Gll^Fp, Ds, Gg, Gll^Fp, Ss, Ss, Ds, Ss, Gs, Gll^Fp, Ss, Ss, Ss, Gg, Gs, Ds, Ds, Ds, Ds, Gs, Gll^Fp, Gll^Fp, Gs, Ss, Gs, Ds, Ds, Gs, Ds, Ds, Ss, Ss, Ss, Gs
Gll^Fp, Gll^Fp, Ss, Ss, Gll^Fp, Ds, Ss, Ss, Ss, Gll^Fp, Gll^Fp, Ds, Ss, Ss, Ds, Ds, Gll^Fp, Ss, Ss, Ss, Gs, Gs, Ss, Gll^Fp, Gll^Fp, Gs, Ds, Ss, Ss, Gll^Fp, Gg, Ss, Ss, Ds, Ds, Gg, Gg, Gll^Fp, Ss, Ss, Gg, Gg, Gg, Gs, Gll^Fp, Gll^Fp, Gll^Fp, Gs, Ss, Gll^Fp, Gs, Gs, Gll^Fp, Gll^Fp, Ss, Ss, Ds, Gll^Fp, Ss, Ss, Ss, Ss
Ss, Ss, Ss, Ss, Gll^Fp, Ds, Gll^Fp, Ss, Ss, Ss, Ds, Ds, Gll^Fp, Gll^Fp, Gs, Gll^Fp, Ss, Ss, Ss, Gg, Gg, Ds, Ss, Ss, Gs, Ds, Ss, Ss, Ss, Gll^Fp, Gs, Gs, Gs, Ds, Gll^Fp, Gg, Gs, Ds, Ds, Ds, Gll^Fp, Gg, Ss, Ss, Ss, Ss, Ss, Ss, Ss, Ss, Ss, Ds, Gll^Fp, Ss, Ss, Ss, Gll^Fp, Gll^Fp, Ss, Ss, Ss, Ss
Ss, Ss, Ss, Ss, Ss, Gll^Fp, Gll^Fp, Ss, Ss, Ss, Gs, Gs, Gg, Gs, Ss, Ss, Ss, Ss, Ss, Gs, Gs, Ds, Ds, Ss, Gs, Gs, Ss, Ss, Ss, Ss, Ss, Gs, Gs, Gs, Gll^Fp, Ss, Ss, Gs, Gs, Gll^Fp, Gll^Fp, Gll^Fp, Ss, Ss, Ss, Ss, Ss, Ss, Ss, Ss, Ss, Ds, Gll^Fp, Ss, Ss, Ss, Gll^Fp, Gll^Fp, Ss, Ss, Ss, Ss
