border_size=1
usage=map

Hh, Hh, Mm, Hh, Mm, Mm, Mm, Mm, Mm, Mm, Mm, Mm^Xm, Mm^Xm, Hh, Hh, Hhd, Hh, Hh, Mm^Xm, Hh, Hhd, Hh, Hh, Hh, Mm, Mm^Xm, Mm^Xm, Mm, Mm, Hh, Hhd, Hh, Mm^Xm, Hhd, Hhd, Hhd, Mm, Mm^Xm, Mm^Xm, Gg, Hhd, Hh, Mm, Mm^Xm, Mm^Xm, Mm, Hh, Mm, Mm, Mm, Mm, Mm^Xm, Mm^Xm, Hh, Mm, Mm^Xm, Mm
Mm, Mm, Mm^Xm, Mm^Xm, Mm, Mm, Mm^Xm, Mm, Mm, Mm^Xm, Mm^Xm, Mm, Mm^Xm, Mm^Xm, Mm^Xm, Mm, Mm, Mm, Mm, Mm^Xm, Mm^Xm, Hh, Mm, Mm^Xm, Mm^Xm, Mm, Mm, Mm^Xm, Mm, Mm, Mm^Xm, Mm, Mm, Mm^Xm, Mm^Xm, Hh, Hhd, Mm, Mm, Mm^Xm, Mm, Hhd, Hhd, Mm, Mm, Mm^Xm, Mm, Hhd, Hhd, Mm, Hh, Mm, Mm, Mm^Xm, Mm, Mm, Hh
Mm, Mm^Xm, Mm^Xm, Mm^Xm, Mm^Xm, Mm, Mm^Xm, Mm^Xm, Mm^Xm, Mm^Xm, Mm, Mm^Xm, Mm, Mm, Mm^Xm, Mm^Xm, Mm^Xm, Mm^Xm, Mm^Xm, Mm, Mm, Mm, Mm^Xm, Mm^Xm, Mm, Mm^Xm, Mm^Xm, Mm, Mm^Xm, Mm, Mm, Mm^Xm, Mm^Xm, Mm^Xm, Mm, Mm^Xm, Mm^Xm, Mm^Xm, Mm^Xm, Mm, Mm^Xm, Hh, Hh, Hh, Mm^Xm, Mm, Hhd, Hh, Mm, Mm^Xm, Mm^Xm, Mm, Mm, Mm, Hhd, Hh, Hh
Mm^Xm, Mm^Xm, Ch, Mm^Xm, Mm^Xm, Mm^Xm, Mm^Xm, Mm, Mm, Mm, Hh, Mm, Mm, Mm^Xm, Mm, Mm, Hhd, Mm, Mm, Mm^Xm, Mm^Xm, Mm^Xm, Mm, Mm, Hhd, Mm, Mm^Xm, Mm, Mm, Mm^Xm, Mm^Xm, Mm^Xm, Mm, Mm, Hh, Hhd, Hhd, Mm, Mm, Mm^Xm, Mm, Mm^Xm, Mm^Xm, Mm, Mm, Mm^Xm, Mm^Xm, Hh, Hh, Mm, Mm, Mm^Xm, Mm, Mm, Mm, Mm^Xm, Mm
Mm, Mm^Xm, Mm^Xm, Hh, Hh, Mm, Mm, Mm, Hhd, Hh, Hh, Hh, Hh, Mm, Hhd, Hhd, Hh, Hhd, Mm^Xm, Mm, Mm, Mm, Hhd, Hh, Hh, Mm, Mm, Mm^Xm, Mm^Xm, Mm^Xm, Mm, Mm, Mm, Hhd, Gs, Gs, Gs, Hh, Mm, Mm, Mm, Mm, Mm, Mm^Xm, Mm^Xm, Mm^Xm, Mm, Mm^Xm, Mm^Xm, Hh, Mm^Xm, Mm, Mm, Mm, Mm, Mm, Hh
Hh, Mm, Mm, Mm^Xm, Mm, Hhd, Hhd, Hh, Hh, Hh, Hhd, Hh, Gs^Ft, Hh, Gs, Hh, Hh, Mm, Mm, Mm, Hh, Hh, Gs^Ft, Gs^Ft, Gs^Ft, Hh, Hhd, Mm, Mm, Mm, Mm, Mm, Hh, Hh, Gs, Gs^Ft, Gs, Hh, Hh, Mm, Mm, Mm, Hhd, Mm, Mm, Mm, Hh, Mm, Mm, Mm^Xm, Mm, Mm^Xm, Mm^Xm, Mm, Mm, Mm, Hh
Hh, Hh, Mm, Mm, Hh, Hhd, Gs^Ft, Gs, Gs, Hh, Gs^Ft, Gs, Gs, Gs^Ft, Gs^Ft, Gs^Ft, Gs^Ft, Hh, Hhd, Hhd, Gs^Ft, Gs^Ft, Gs^Ft, Gs, Gs^Ft, Gs, Gs^Ft, Hh, Hh, Hhd, Hh, Hh, Gs^Ft, Gs^Ft, Gs^Ft, Gs^Ft, Gs^Ft, Gs^Ft, Gs^Ft, Hh, Hhd, Hh, Gs^Ft, Hh, Hh, Hhd, Gs^Ft, Hh, Hh, Mm, Hh, Mm^Xm, Mm, Mm, Hhd, Hhd, Hh
Mm, Mm, Mm, Mm, Hh, Hhd, Gs, Gs^Ft, Gs^Ft, Gs, Gs, Gs, Gs, Gs^Ft, Gs^Ft, Gs, Gs^Ft, Gs^Ft, Gs^Ft, Gs, Gs^Ft, Gs^Ft, Gs^Ft, Gs^Ft, Gs^Ft, Gs^Ft, Gs, Gs^Ft, Gs^Ft, Gs, Gs^Ft, Gs, Gs^Ft, Gs^Ft, Gs^Ft, Gs^Ft, Gs, Gs^Ft, Gs, Gs, Gs, Gs^Ft, Gs^Ft, Gs, Gs^Ft, Gs, Gs^Ft, Gs, Gs, Hh, Mm, Mm^Xm, Mm^Xm, Hhd, Mm, Mm^Xm, Mm
Hhd, Mm, Hh, Hhd, Gs, Gs, Gd^Fts, Gd^Fts, Gs^Ft, Gs^Ft, Gs^Ft, Gs, Gs^Ft, Gs, Gs^Ft, Gs, Gs, Gs, Gs, Gs^Ft, Gs^Ft, Gs, Gs, Gs, Gs^Ft, Gs^Ft, Gs, Gs^Ft, Gs, Gs^Ft, Gs^Ft, Gs, Gs, Gs^Ft, Gs, Gs^Ft, Gs^Ft, Gs^Ft, Gs, Gs, Gs, Gs, Gs, Gs, Gs, Gs^Ft, Gs, Gs^Ft, Gs, Hh, Hh, Mm, Mm, Mm^Xm, Mm^Xm, Mm, Mm
Hh, Hh, Hh, Hhd, Gd^Fts, Gs, Gs, Gs, Gs^Ft, Gs, Gs, Gs^Ft, Gs, Gs, Gs^Ft, Gs^Ft, Gs^Ft, Gs, Gs^Ft, Gs^Ft, Gs^Ft, Gs, Gs, Gs, Gs^Ft, Gs, Gs^Ft, Gs, Gs^Ft, Gs^Ft, Gs^Ft, Gs^Ft, Gs^Ft, Gs^Ft, Gs, Gs^Ft, Gs^Ft, Gs, Gs, Gs^Ft, Gs^Ft, Gs, Gs, Gs^Ft, Gs, Gs^Ft, Gs^Ft, Gs^Ft, Gs, Gs, Gs^Ft, Hhd, Hh, Mm, Mm, Mm^Xm, Mm
Hh, Hh, Gs, Gs, Gs, Gs, Gs, Gs, Gs, Gs^Ft, Gs^Ft, Gs^Ft, Gs, Gs^Ft, Gs^Ft, Gs^Ft, Gs^Ft, Gs^Ft, Gs^Ft, Gs, Gs, Gs^Ft, Gs, Gs^Ft, Gs, Gs^Ft, Gs, Gs^Ft, Gs^Ft, Gs, Hhd, Gs, Hh, Gs^Ft, Gs, Gs, Hh, Gs^Ft, Gs, Gs, Gs^Ft, Gs^Ft, Gs^Ft, Gs, Gs, Gs^Ft, Gs, Gs^Ft, Gs, Gs^Ft, Gs^Ft, Gs, Gs, Hhd, Hh, Mm, Hh
Gs, Gs, Gs, Gd^Fts, Gd^Fts, Hh, Gd^Fts, Gs, Gs, Gs, Gs, Gs, Gs^Ft, Gs^Ft, Gs^Ft, Gs, Gs, Gs, Gs^Ft, Gs, 5 Gs, Gs, Gs, Gs^Ft, Gs, Gs^Ft, Gs, Gs, Hh, Hh, Hh, Hh, Mm^Xm, Hhd, Hh, Hhd, Mm^Xm, Hhd, Hh, Gs^Ft, Gs^Ft, Gs, Gs, Gs^Ft, Gs, Gs, Gs^Ft, Gs^Ft, Gs, Gs, Gs, Gs, Gs^Ft, Hh, Hh, Hhd, Hhd
Gs, Gs, Gd^Fts, Gs, Gs, Gd^Fts, Gd^Fts, Gs, Gd^Fts, Gs, Gs, Gs, Gd^Fts, Gs^Ft, Gs^Ft, Gs^Ft, Gs, Gs, Gs^Ft, Gs, Gs, Gs, Gs, Gs^Ft, Gs, Gs^Ft, Hh, Hh, Mm^Xm, Mm, Mm, Mm, Mm, Mm^Xm, Mm^Xm, Mm, Mm, Mm^Xm, Mm^Xm, Hhd, Hh, Gs^Ft, Gs^Ft, Gs, Gs^Ft, Gs, Gs, Gs, Gs^Ft, Gs^Ft, Gs^Ft, Gs^Ft, Gs, Gs, Gs, Hhd, Hh
Gs, Gs, Gs, Gs, Gs, Gs, Gs, Gs, Gs, Gd^Fts, Gs, Gd^Fts, Gs, Gs, Gs^Ft, Gs, Gs, Gs, Gs, Gs^Ft, Gs, Gs^Ft, Gs^Ft, Gs^Ft, Hhd, Hh, Mm, Mm, Mm, Mm, Hh, Mm, Hh, Mm, Mm, Mm, Mm, Mm, Mm, Mm, Hhd, Gs, Gs, Gs^Ft, Gs^Ft, Gs^Ft, Gs, Gs, Gs, Gs^Ft, Gs, Gs^Ft, Gs, 2 Gs, Gs, Gs, Gs
Gd^Fts, Hhd, Gd^Fts, Gs, Gs, Gs, Gs, Gd^Fts, Gs, Gs, Gs, Gs, Gs, Hh, Gs, Gs, Gs, Gs, Gs, Gs, Gs^Ft, Gs, Gs^Ft, Hh, Mm, Mm^Xm, Mm, Mm, Mm, Hh, Hhd, Hh, Gs, Hhd, Hhd, Hh, Hh, Mm, Hh, Hh, Hh, Hhd, Gs, Gs^Ft, Gs^Ft, Gs, Gs, Gs^Ft, Gs^Ft, Gs, Gs^Ft, Gs, Gs, Gs, Gs, Gs, Gs
Hh, Gs, Gs, Hh, Gs, Gs, Gs, Gs, Gs, Gs, Gs, Gs, Gs, Gs, Gs, Gd^Fts, Gs, Gs, Gs, Gs, Gs, Gs^Ft, Gs, Hh, Hh, Mm, Mm, Mm, Mm, Hhd, Hhd, Gd^Fts, Gs, Gs, Gs, Gd^Fts, Hhd, Mm, Hhd, Mm, Mm, Hhd, Hhd, Gs^Ft, Gs^Ft, Gs, Gs^Ft, Gs, Gs^Ft, Gs^Ft, Gs^Ft, Gs, Gs, Gd^Fts, Gd^Fts, Gs, Gd^Fts
Gs, Gs, Gd^Fts, Hhd, Gs, Gs, Gd^Fts, Gs, Gs, Gd^Fts, Gs, Gd^Fts, Gd^Fts, Gs, Gd^Fts, Gs, Gd^Fts, Gd^Fts, Gs, Gs, Gs, Gd^Fts, Gd^Fts, Gd^Fts, Hhd, Mm, Hh, Mm, Hhd, Hhd, Gs, Gs, Gs, Gs, Gs, Gs, Hh, Hh, Hh, Hh, Hhd, Mm, Hhd, Hhd, Gs, Gs^Ft, Gs^Ft, Gs^Ft, Gs^Ft, Gs^Ft, Gs, Gs, Gs, Gd^Fts, Gs, Gd^Fts, Gs
Gs, Gs, Gs, Gs, Gs, Gs, Gs, Gs, Gs, Gs, Gs, Gs, Gd^Fts, Gs, Gs, Gs, Gs, Gs, Gs, Gs, Gs, Gs, Gs, Gd^Fts, Gs, Hh, Gs, Hhd, Hh, Gs, Gs, Gs, Gd^Fts, Gs, Hh, Gs, Gs, Gs, Hh, Hhd, Mm, Mm^Xm, Mm^Xm, Hh, Hhd, Gs^Ft, Gs, Gs, Gs, Gs, Gd^Fts, Gs, Gs, Hh, Gs, Gd^Fts, Gs
Gs, Gs, Gd^Fts, Gs, Gs, Gs, Gs, Gs, Gd^Fts, Gs, Gs, Gd^Fts, Gs, Gs, Gs, Gs, Gd^Fts, Gs, Gs, Gs, Gs, Gs, Gs, Gs, Gs, Gs, Gs, Gs, Gs, Gs, Gd^Fts, Hhd, Gs, Hhd, Gd^Fts, Gs, Gs, Gs, Hhd, Hh, Hh, Mm, Mm, Mm^Xm, Mm, Hh, Gd^Fts, Gs, Gs, Gs, Gs, Gd^Fts, Gs, Gs, Gs, Gs, Gs
Gs, Gd^Fts, Gs, Gs, Gs, Gs, Gs, Gd^Fts, Gs, Gs, Hhd, Gs, Gs, Gs, Gs, Gs, Gs, Gs, Gd^Fts, Hhd, Gd^Fts, Gs, Gs, Gs, Gs, Gs, Gs, Gs, Hh, Gs, Gs, Gs, Gd^Fts, Gs, Gs, Gs, Gs, Gs, Gd^Fts, Hhd, Mm, Hhd, Hh, Mm, Hhd, Hh, Gs, Gd^Fts, Gs, Gd^Fts, Gs, Gs, Gs, Gs, Gs, Gs, Gs
Gs, Gs, Gd^Fts, Gs, Gd^Fts, Gs, Gd^Fts, Gd^Fts, Gs, Gs, Hhd, Hhd, Hh, Gs, Gs, Gs, Gs, Gs, Gs, Gs, Hhd, Gs, Hhd, Gs, Gs, Hhd, Gs, Gs, Gs, Gs, Gs, Gs, Hh, Gs, Gs, Hh, Gd^Fts, Gs, Gs, Hhd, Hh, Mm, Mm, Hh, Gs, Gd^Fts, Gs, Gs, Gs, Gs, Gs, Gs, Gs, Hh, Gs, Gd^Fts, Gs
Gs, Gs, Gs, Hhd, Gs, Gs, Hh, Gs, Hh, Hh, Mm, Mm^Xm, Mm^Xm, Hh, Hh, Gs, Gd^Fts, Gs, Gs, Gs, Hh, Gs, Gd^Fts, Gs, Gs, Gs, Gs, Gs, Gs, Gs, Gs, Gd^Fts, Gs, Gs, Gs, Gs, Gs, Gs, Gs, Gs, Gd^Fts, Hh, Hh, Hh, Hhd, Gs, Gs, Hhd, Gs, Hh, Gs, Gs, Gs, Gs, Gs, Gs, Gs
Gs, Hh, Gs, Gs, Gs, Hh, Mm, Hh, Hh, Hhd, Mm^Xm, Mm, Mm, Mm^Xm, Mm, Hhd, Hh, Gs, Gs, Gs, Hh, Hh, Gs, Gs, Gd^Fts, Gs, Gd^Fts, Gs, Gs, Gs, Gd^Fts, Gs, Gs, Gs, Gs, Gd^Fts, Gs, Gs, Gs, Gs, Gs, Gs, Gs, Gs, Hhd, Hhd, Gs, Gs, Gs, Gs, Hhd, Gs, Gs, Gs, Gs, Gs, Gs
Gs, Gs, Gs, Gs, Hh, Hh, Mm, Mm, Mm, Mm, Mm, Mm, Hh, Mm, Mm^Xm, Hhd, Hh, Gs, Gs, Gs, Gs, Gs, Gs, Gs, Hh, Gs, Gd^Fts, Gs, Gd^Fts, Gs, Gs, Gs, Gd^Fts, Gs, Gs, Gs, Hh, Gs, Hhd, Gs, Gs, Hh, Gs, Gd^Fts, Gs, Gs, Gs, Gs, Gs, Gs, Gs, Gs, Gd^Fts, Gs, Gs, Gd^Fts, Gd^Fts
Gs, Gs, Gs, Hhd, Gs, Hhd, Hh, Mm, Mm, Hhd, Mm, Mm^Xm, Mm^Xm, Mm, Mm, Mm, Hhd, Gs, Gs, Hh, Gd^Fts, Gs, Hh, Hh, Mm^Xm, Hhd, Hh, Gs, Gs, Hhd, Gs, Gs, Gs, Gs, Gs, Gd^Fts, Gs, Gs, Gs, Gs, Gd^Fts, Gs, Gs, Gs, Gs, Gs, Gs, Gs, Gs, Gd^Fts, Gd^Fts, Gs, Gs, Gd^Fts, Gs, Hh, Hh
Gs, Gs, Gd^Fts, Gs, Gs, Gd^Fts, Gs, Hh, Hhd, Hh, Hhd, Mm, Mm, Mm^Xm, Mm, Hhd, Gd^Fts, Gs, Gs, Gd^Fts, Gs, Gs, Hh, Mm, Mm, Mm, Hh, Gs, Gs, Gs, Hh, Gs, Gs, Gs, Gs, Gs, Gs, Gs, Gd^Fts, Gd^Fts, Gs, Gs, Gd^Fts, Gs, Gs, Gs, Gs, Gd^Fts, Gd^Fts, Gs, Gd^Fts, Gs, Gs, Gs, Gs, Gs, Gs
Gs, Gs, Gs, Gd^Fts, Gs, Gs, Gs, Gs, Gs, Gs, Gs, Hh, Hhd, Mm, Mm, Hh, Hhd, Gs, Gs, Gs, Gs, Gs, Hh, Hh, Hhd, Hh, Mm, Hhd, Gs, Hhd, Gs, Gs, Gs, Gs, Gs, Gd^Fts, Gd^Fts, Gs, Gd^Fts, Gs, Gs, Gs, Hh, Gs, Gs, Gs, Gs, Gs, Gd^Fts, Gs, Gs, Gs, Gs, Gs, Gs, Gd^Fts, Gs
Gs, Gs, Gd^Fts, Gs, Gs, Gd^Fts, Gs, Gs, Gs, Gd^Fts, Gs, Gs, Hhd, Hhd, Mm, Mm, Mm, Hhd, Gs, 4 Gs, Gs, Gs, Hh, Hhd, Mm, Mm, Hh, Hhd, Gs, Gs, Gs, Gs, Gs, Gs, Gs, Gs, Gs, Gs, Gs, Gs, Gs, Gs, Hhd, Gs, Gs, Gs, Gs, Gd^Fts, Gs, Gd^Fts, Hhd, Gs, Gs, Gs, Gd^Fts, Gd^Fts, Gs
Gs, Gd^Fts, Gs, Gs, Gs, Gs, Gs, Gs, Gd^Fts, Gs, Gs, Gs, Gs, Hh, Hhd, Mm, Mm, Hh, Hh, Gd^Fts, Hh, Hh, Mm, Mm^Xm, Mm^Xm, Hhd, Hhd, Gs, Gs, Gs, Gd^Fts, Gs, Gs, Gs, Gs, Gs, Gs, Gs, Gd^Fts, Gs, Gs, Hh, Gd^Fts, Gs, Gs, Gs, Gs, Gd^Fts, Gd^Fts, Gd^Fts, Gs, Hhd, Gs, Gs, Gd^Fts, Gs, Gd^Fts
Gs, Gs, Gs, Hh, Gs, Gs, Gd^Fts, Gs, Gs, Gs, Gs, Gs, Gs, Gd^Fts, Hhd, Hh, Mm, Mm^Xm, Mm^Xm, Hh, Mm, Mm^Xm, Mm^Xm, Mm, Mm, Mm^Xm, Mm, Hh, Gs, Gd^Fts, Gd^Fts, Hhd, Gs, Gs, Gs, Gs, Gd^Fts, Hh, Gs, Gs, Gd^Fts, Gs, Gd^Fts, Gs, Gs, Gd^Fts, Gs, Gs, Gs, Gs, Gd^Fts, Gs, Gs, Gs, Gs, Gs, Gd^Fts
Gs, Hh, Gs, Gs, Gs, Hhd, Gs, Gs, Gs, Gs, Gs, Gs, Gs, Gs, Gs, Hh, Mm, Mm, Mm, Mm^Xm, Mm, Mm, Mm, Mm^Xm, Mm, Mm, Hhd, Hh, Hh, Gd^Fts, Gs, Gs, Hh, Gd^Fts, Gs, Gs, Gs, Gs, Gs, Gs, Gs, Gs, Gs, Gd^Fts, Gs, Hhd, Gs, Gs, Gs, Gs, Gd^Fts, Hh, Gs, Gs, Gs, Gs, Gs
Gs, Gs, Gd^Fts, Gs, Gd^Fts, Gs, Gs, Gd^Fts, Gs, Gd^Fts, Gd^Fts, Gs, Gs, Gs, Gs, Hh, Hhd, Mm, Mm, Mm, Hhd, Hhd, Hh, Mm, Hhd, Hhd, Gs, Gs, Gs, Gs, Gs, Gs, Hh, Gs, Hhd, Gs, Gs, Gd^Fts, Gs, Gs, Gs, Gs, Gd^Fts, Gd^Fts, Gs, Gs, Gs, Gs, Gd^Fts, Gs, Gs, Hh, Gs, Gs, Gs, Gs, Gs
Gd^Fts, Gd^Fts, Gs, Gd^Fts, Gs, Gs, Gd^Fts, Gs, Gs, Gs, Gs, Gs, Gs, Gs, Gd^Fts, Gs, Gs, Hhd, Hh, Hh, Gd^Fts, Hh, Gs, Hh, Hh, Gs, Gd^Fts, Gd^Fts, Gs, Gs, Gs, Gs, Gs, Gs, Gs, Gs, Gd^Fts, Gs, Gs, Gs, Gs, Gd^Fts, Gs, Gs, Gs, Gs, Gs, Gs, Gs, Gs, Gd^Fts, Gs, Gs, Gd^Fts, Gs, Gs, Gs
Gs, Gs, Hhd, Gd^Fts, Hhd, Gs, Gs, Gs, Gd^Fts, Gs, Gd^Fts, Gs, Gs, Gs, Gd^Fts, Gs, Hhd, Gd^Fts, Gd^Fts, Gs, Gs, Gs, Gd^Fts, Gs, Gs, Gs, Gs, Gs, Gs, Gs, Gs, Gd^Fts, Gs, Gs, Gs, Gs, Gs, Gs, Gd^Fts, Gs, Gs, Hh, Gs, Gd^Fts, Gs, Gs, Hh, Hh, Gs, Gs, Gs, Hhd, Gs, Gs, Hh, Gd^Fts, Gs
Gs, Gs, Gs, Gs, Hhd, Gs, Gs, Gs, Gs, Gs, Hh, Gs, Gs, Gs, Gs, Gs, Gs, Gs, Gd^Fts, Gd^Fts, Gs, Gd^Fts, Gs, Gs, Gs, Gs, Gs, Gd^Fts, Gs, Gs, Gs, Gs, Gd^Fts, Gs, Gs, Gs, Gd^Fts, Gs, Gs, Gs, Gs, Gs, Hhd, Gs, Gs, Gs, Gs, Gs, Gs, Gs, Gs, Gs, Gs, Gs, Gs, Gs, Ds
Gs, Gs, Hhd, Gd^Fts, Gs, Hhd, Gs, Gd^Fts, Gs, Gd^Fts, Gs, Gs, Gs, Gs, Gs, Gs, Gs, Gs, Gs, Gs, Gd^Fts, Gs, Gd^Fts, Gs, Gs, Gs, Gs, Gs, Gs, Gs, Hh, Gs, Gs, Gs, Gs, Gs, Gs, Gs, Gs, Gs, Gs, Hh, Gs, Gd^Fts, Gs, Gs, Hh, Gs, Gs, Gs, Gs, Gd^Fts, Gd^Fts, Gs, Ds, Ds, Ww
Gs, Gs, Gs, Gs, 3 Gs, Gs, Hh, Gs, Gs, Gd^Fts, Gs, Gd^Fts, Gs, Gs, Gs, Gs, Gs, Hhd, Gs, Gs, Gd^Fts, Gs, Gs, Gd^Fts, Gs, Hh, Gs, Gs, Gs, Gs, Gs, Gs, Gs, Gs, Gd^Fts, Gd^Fts, Gd^Fts, Gs, Gs, Gd^Fts, Gd^Fts, Gs, Gs, Gs, Gs, Gs, Gs, Hhd, Hh, Gd^Fts, Gs, Gs, Gs, Ds, Ww, Ww, Ww
Ds, Gs, Gs, Gs, Gs, Gs, Gd^Fts, Gd^Fts, Gs, Gs, Gs, Gs, Gd^Fts, Gs, Gs, Gs, Gd^Fts, Gd^Fts, Gs, Gs, Gs, Gs, Gd^Fts, Gs, Gs, Gs, Gs, Gs, Gs, Gs, Gd^Fts, Gs, Gs, Gs, Gd^Fts, Gs, Gs, Gs, Gs, Gs, Hhd, Gs, Gs, Gd^Fts, Gs, Gs, Gd^Fts, Gs, Gs, Gs, Gs, Hh, Ds, Wwf, Ww, Ww, Wo
Wwf, Ds, Ds, Gs, Gd^Fts, Gs, Gs, Gs, Hhd, Gs, Gs, Gd^Fts, Gs, Gs, Gs, Gs, Gs, Gd^Fts, Gd^Fts, Gd^Fts, Gd^Fts, Hhd, Gd^Fts, Gs, Gs, Gs, Gs, Gs, Gs, Gs, Hh, Gs, Gs, Gs, Gd^Fts, Gs, Gd^Fts, Gs, Gd^Fts, Gs, Gs, Gs, Gs, Gs, Gd^Fts, Gs, Gs, Hhd, Ce, Gd^Fts, Gd^Fts, Gs, Ww, Ww, Wwr, Ww, Wo
Ww, Wwf, Ww, Ds, Ds, Gs, Hhd, Gs, Gs, Gs, Gs, Gs, Gs, Gd^Fts, Gs, Gs, Gd^Fts, Gs, Gs, Gs, Ds, Gs, Ds, Gs, Gs, Gs, Gs, Gs, Hh, Gs, Gs, Hh, Gs, Gs, Gs, Gs, Gs, Gs, Gs, Gd^Fts, Ds, Hh, Ds, Gs, Gs, Gs, Gd^Fts, Ce, 1 Ket, Hh, Gd^Fts, Ds, Ww, Wwr, Ww, Ww, Wo
Ww, Ww, Wwr, Ww, Ww, Ds, Ds, Gs, Ds, Gd^Fts, Ds, Gs, Ds, Gs, Ds, Ds, Wwf, Ds, Ds, Ds, Wwf, Wwf, Ww, Ds, Ww, Ds, Ds, Gs, Gs, Gs, Hhd, Gs, Gs, Gs, Gd^Fts, Gs, Gs, Gs, Ds, Ds, Wwf, Wwf, Ww, Ds, Ds, Hhd, Gs, Ce, Ce, Ce, Ds, Ds, Ww, Wwr, Ww, Wo, Wo
Wo, Ww, Ww, Wwr, Ww, Ww, Ww, Wwf, Ww, Ds, Wwf, Wwf, Wwf, Wwf, Ww, Ww, Ww, Ww, Ww, Wwf, Ww, Ww, Ww, Ww, Ww, Ww, Ww, Ds, Ds, Gs, Ds, Gs, Ds, Gd^Fts, Ds, Gs, Ds, Ds, Ww, Ww, Ww, Ww, Wwr, Ww, Ww, Ds, Ww, Ds, Ds, Ds, Ww, Ww, Ww, Ww, Wo, Wo, Wo
Wo, Wo, Wo, Ww, Wo, Ww, Ww, Ww, Wwr, Ww, Ww, Wwf, Ww, Ww, Ww, Ww, Ww, Wwr, Wwr, Ww, Ww, Ww, Wo, Ww, Wo, Ww, Ww, Ww, Ww, Ds, Wwf, Wwf, Ww, Ww, Ww, Ds, Ww, Ww, Ww, Ww, Ww, Ww, Ww, Wwr, Wwr, Ww, Ww, Ww, Ww, Ww, Wwr, Wwr, Ww, Wo, Wo, Wo, Wo
Wo, Wo, Wo, Wo, Wo, Wo, Wo, Ww, Ww, Wwr, Ww, Ww, Wo, Wo, Wo, Wo, Wo, Ww, Ww, Ww, Wo, Wo, Wo, Wo, Wo, Wo, Ww, Wwr, Wwr, Ww, Ww, Ww, Ww, Ww, Ww, Ww, Ww, Ww, Wo, Wo, Wo, Wo, Wo, Ww, Ww, Ww, Wo, Ww, Ww, Ww, Ww, Ww, Wo, Wo, Wo, Wo, Wo
Wo, Wo, Wo, Wo, Wo, Wo, Wo, Wo, Wo, Ww, Wo, Wo, Wo, Wo, Wo, Wo, Wo, Wo, Wo, Wo, Wo, Wo, Wo, Wo, Wo, Wo, Wo, Ww, Ww, Wwr, Ww, Ww, Wo, Wo, Wo, Ww, Wo, Wo, Wo, Wo, Wo, Wo, Wo, Wo, Wo, Wo, Wo, Wo, Wo, Wo, Wo, Wo, Wo, Wo, Wo, Wo, Wo
Gg, Wo, Wo, Wo, Wo, Wo, Wo, Wo, Wo, Wo, Wo, Wo, Wo, Wo, Wo, Wo, Wo, Wo, Wo, Wo, Wo, Wo, Wo, Wo, Wo, Wo, Wo, Wo, Wo, Ww, Wo, Wo, Wo, Wo, Wo, Wo, Wo, Wo, Wo, Wo, Wo, Wo, Wo, Wo, Wo, Wo, Wo, Wo, Wo, Wo, Wo, Wo, Wo, Wo, Wo, Wo, Wo
