border_size=1
usage=map

Wog, Wog, Wog, Wog, Wog, Wog, Wog, Wog, Wog, Wog, Wog, Wog, Wog, Wog, Wog, Wog, Wog, Wog, Wwg, Wwg, Ds, Gs, Gs, Gs, Gs, Gs, Gs, Gs, Gs, Gs, Gs, Gs, Gs, Gs, Gs, Gs, Gs^Ft, Gs^Ft, Gs, Gs, Gs^Ft, Gg, Gs^Ft, Gs, Gs^Ft, Gg, Gs^Ft, Gg, Gs^Ft, Gs, Gs, Gs^Ft, Gs^Ft, Gs^Ft, Gs^Ft, Gs, Gs, Gs, Gs, Gs, Gs
Wog, Wog, Wog, Wog, Wog, Wog, Wog, Wog, Wog, Wog, Wog, Wog, Wog, Wog, Wwg, Wwg, Wwg, Wwg, Wwg, Wwg, Gs, Gs, Gs, Gs, Gs, Gs, Gs, Gs, Gs, Gs, Gs, Gs, Gs, Gs, Gs, Gs, Gs^Ft, Gs^Ft, Gs, Gs^Ft, Ce, Ce, Ce, Gs^Vl, Gs^Ft, Gs^Ft, Gs, Gs^Ft, Gs, Gs, Gs, Gs^Ft, Gs^Ft, Gs^Ft, Gs, Gs, Gs^Ft, Gs, Gs^Ft, Gs, Gs
Wog, Wog, Wog, Wog, Wog, Wog, Wog, Wog, Wog, Wog, Wog, Wog, Wwg, Wwg, Wwg, Wwg, Wwg, Wwg, Ds, Ds, Gs, Gs, Gs, Gs, Gs, Gs, Gs, Gs, Gs, Gs, Gs, Gs, Gs, Gs, Gs, Gs, Gs, Gs^Vl, Gs, Gs^Ft, Ce, 9 Ke, Ce, Gs, Gs, Gs, Gs^Ft, Gs, Gs^Ft, Gs^Ft, Gs^Ft, Gs, Gs, Gs^Vl, Gs^Ft, Gs^Ft, Gs^Ft, Gs^Vl, Gs, Gs^Ft, Gs
Wog, Wog, Wog, Wog, Wog, Wog, Wog, Wog, Wog, Wog, Wog, Wog, Wwg, Wwg, Ds, Ds, Gs, Ds, Gs, Gs, Gs, Gs, Gs, Gs, Gs, Gs, Gs, Gs, Gs, Gs, Gs, Gs, Gs, Gs, Gs^Ft, Gs^Ft, Gs^Ft, Gs, Gs, Gs, Gs^Ft, Ce, Gs^Ft, Gs, Gs^Ft, Gs^Ft, Gs, Gs, Gs^Ft, Gs^Vl, Gs, Gs^Ft, Gs^Ft, Gs, Gs^Ft, Gs^Ft, Gs, Gs, Gs^Ft, Gs, Gs^Ft
Wog, Wog, Wog, Wog, Wog, Wog, Wog, Wog, Wog, Wog, Wwg, Wwg, Wwg, Wwg, Gs, Gs, Gs, Gs, Gs, Gs, Gs, Gs, Gs, Gs, Gs, Gs, Gs, Gs, Gs, Gs, Gs, Gs, Gs, Gs, Gs, Gs^Vl, Gs^Ft, Gs^Ft, Gs, Gs^Ft, Gs^Ft, Gs^Ft, Gs, Gs^Ft, Gs, Gs^Ft, Gs, Gs^Ft, Gs^Ft, Gs^Ft, Ce, Ce, Ce, Gs, Gs, Gs^Ft, Gs, Gs^Ft, Gs, Gs, Gs^Ft
Wog, Wog, Wog, Wog, Wog, Wog, Wwg, Wog, Wog, Wog, Wwg, Wwg, Ds, Ds, Gs, Gs, Gs, Gs, Gs, Gs, Gs, Gs, Gs, Gs, Gs, Gs, Gs, Gs, Hhd, Gs, Hhd, Gs, Gs^Ft, Gs^Ft, Gs^Ft, Gs, Hhd, Gs^Ft, Hh, Gs^Ft, Gs^Vl, Gs, Gs^Ft, Gs, Gs^Ft, Gs, Gs^Ft, Gs, Gs, Gs^Ft, Ce, 8 Ke, Ce, Gs^Ft, Gs^Ft, Gs, Gs, Gs^Ft, Gs^Ft, Gs, Gs
Wog, Wog, Wog, Wog, Wwg, Wwg, Wwg, Wwg, Wwg, Wwg, Wwg, Wwg, Gs, Gs, Gs, Gs, Gs, Gs, Gs, Gs, Hhd, Hh, Hh, Gs, Hhd, Gs, Hh, Hh, Mm, Hhd, Hh, Hh, Hhd, Hhd, Hh, Hh, Mm, Hhd, Mm, Hh, Hhd, Hhd, Hh, Gs^Ft, Gs^Ft, Gs^Ft, Gs, Gs^Ft, Gs, Gs^Ft, Gs^Ft, Ce, Gs^Ft, Gs, Gs, Gs^Ft, Gs^Ft, Gs, Gs, Gs^Ft, Gs
Wog, Wog, Wwg, Wwg, Wwg, Wwg, Ds, Wwg, Wwg, Wwg, Ds, Ds, Gs, Gs, Gs, Gs, Gs, Gs, Hh, Hh, Hhd, Hh, Mm^Xm, Hhd, Mm, Hhd, Hh, Mm, Mm, Mm^Xm, Mm^Xm, Hh, Mm, Mm^Xm, Mm, Mm, Mm^Xm, Mm, Mm, Mm, Mm, Mm, Mm, Hh, Hhd, Gs, Gs, Gs^Ft, Gs^Ft, Gs^Vl, Gs^Ft, Gs, Gs, Gs^Ft, Gs, Gs^Ft, Gs^Ft, Gs^Ft, Gs^Ft, Gs, Gs
Wog, Wwg, Wwg, Wwg, Ds, Ds, Gs^Vl, Ds, Gs, Ds, Gs, Gs, Gs, Gs^Vl, Gs, Gs, Gs, Gs, Hh, Hhd, Mm, Mm, Mm, Mm^Xm, Mm^Xm, Mm, Mm, Mm, Mm, Mm, Mm, Mm^Xm, Mm, Mm, Mm^Xm, Mm^Xm, Mm, Mm, Mm^Xm, Mm, Mm, Mm^Xm, Mm, Mm, Hh, Gs^Ft, Gs^Ft, Gs^Ft, Gs^Ft, Gs^Ft, Gs^Ft, Gs^Ft, Gs, Gs^Ft, Gs^Ft, Gs, Gs^Ft, Gs, Gs^Vl, Gs^Ft, Gs
Wwg, Wwg, Wwg, Ds, Gs, Gs, Gs, Gs, Ce, Ce, Ce, Gs, Gs, Gs, Gs, Gs, Gs, Hhd, Hhd, Mm, Mm, Mm, Mm, Mm, Mm, Mm, Mm, Mm, Mm, Mm, Mm^Xm, Mm, Mm^Xm, Mm, Mm, Mm, Mm^Xm, Mm^Xm, Xu, Mm^Xm, Mm^Xm, Mm, Mm, Mm, Mm, Hhd, Hhd, Gs, Gs, Gs^Ft, Gs^Ft, Gs^Ft, Gs, Gs^Ft, Gs^Ft, Gs, Gs^Ft, Gs^Ft, Gs^Ft, Gs^Ft, Gs^Ft
Wwg, Wwg, Ds, Gs, Gs, Gs, Ce, Ce, 1 Ke, Ce, Ce, Gs, Gs, Gs, Gs, Gs, Hh, Hhd, Mm, Mm, Mm^Xm, Mm, Mm, Mm, Mm, Mm, Mm^Xm, Mm, Mm^Xm, Mm^Xm, Xu, Mm^Xm, Mm^Xm, Mm^Xm, Mm^Xm, Mm^Xm, Mm^Xm, Xu, Cud, Xu, Xu, Mm^Xm, Mm^Xm, Mm, Mm, Mm, Mm, Hh, Hhd, Gs^Ft, Gs^Ft, Gs^Ft, Gs^Ft, Gs, Gs^Ft, Gs, Gs, Gs^Ft, Gs^Ft, Gs^Ft, Gs
Ds, Ds, Gs, Gs, Gs, Gs, Ce, Ce, Ce, Ce, Gs, Gs, Gs, Gs, Gs, Gs, Hhd, Hh, Mm^Xm, Mm^Xm, Mm, Mm, Mm, Mm, Mm^Xm, Mm^Xm, Xu, Mm^Xm, Xu, Xu, Xu, Xu, Xu, Mm^Xm, Mm^Xm, Mm^Xm, Mm^Xm, Xu, Sm, Sm, Sm, Xu, Xu, Mm^Xm, Mm, Mm, Mm^Xm, Hh, Hhd, Hhd, Hh, Gs^Vl, Gs^Ft, Gs, Gs, Gs, Ce, Ce, Ce, Gs, Gs
Gs, Gs, Gs, Gs^Vl, Gs, Gs, Gs, Ce, Gs, Gs, Gs, Gs, Gs^Vl, Gs, Gs, Gs, Hhd, Mm, Mm, Mm, Mm, Mm, Mm^Xm, Mm^Xm, Xu, Xu, Xos, Xu, Xos, Xos, Xos, Xu, Xu, Xu, Xu, Mm^Xm, Xu, Xu, Sm, Sm, Sm, Sm, Xu, Mm^Xm, Mm^Xm, Mm, Mm, Mm, Mm, Mm, Mm, Hh, Hhd, Gs^Ft, Gs, Gll^Ft, Ce, 7 Ke, Ce, Gs^Ft, Gs
Gs, Gs, Gs, Gs, Gs, Gs, Gs, Gs, Gs, Gs, Gs, Gs, Gs, Gs, Gs, Gs, Hh, Hhd, Mm^Xm, Mm, Mm^Xm, Mm^Xm, Xu, Xu, Xos, Xos, Cud, Xos, Cud, Cud, Cud, Xos, Xos, Xos, Xos, Xu, Xos, Xu, Xu, Sm, Sm, Sm, Sm, Xu, Xu, Mm^Xm, Mm^Xm, Mm, Mm^Xm, Mm, Mm, Mm, Hh, Hhd, Hh, Hhd, Gll^Ft, Ce, Gll^Ft, Gs, Gs
Gs, Gs, Gs, Gs, Gs, Gs, Gs, Gs, Gs, Gs, Gs, Gs, Gs, Gs, Gs, Gs, Hh, Mm, Mm, Mm, Mm^Xm, Xu, Xu, Xos, Cud, Cud, Urb, Urb, Urb, Urb, Urb, Cud, Cud, Cud, Cud, Xos, Cud, Xos, Xos, Cud, Sm, Sm, Sm, Sm, Sm, Xu, Mm^Xm, Mm, Mm, Mm^Xm, Mm^Xm, Mm, Mm, Hhd, Hh, Hhd, Hhd, Gs^Vl, Hhd, Gll^Ft, Gll^Ft
Gs, Gs, Gs, Gs, Gs, Gs, Gs, Gs, Gs, Gs, Gs, Gs, Gs, Gs, Gs, Gs, Hhd, Hh, Mm, Mm^Xm, Xu, Xu, Xu, Xos, Cud, Urb, Uu, Uu, Uh, Uu, Uu, Urb, Urb, Urb, Urb, Cud, Urb, Cud, Urb, Uu, Uu, Sm, Sm, Sm, Sm, Xu, Mm^Xm, Mm, Mm, Mm, Mm, Mm, Mm, Mm, Mm, Hh, Mm, Hh, Hhd, Hhd, Hh
Gs, Gs, Gs, Gs, Gs, Gs, Hh, Gs, Gs, Gs, Gs, Gs, Gs, Gs, Gs, Hhd, Mm, Mm, Mm, Mm^Xm, Xu, Xu, Xu, Xos, Xos, Urb, Uu, Sm, Uh, Sm, Uu, Urb, Cud, Cud, Cud, Urb, Urb, Urb, Urb, Urb, Xos, Cud, Xu, Sm, Xu, Xu, Mm^Xm, Mm, Mm, Mm, Mm, Mm^Xm, Mm^Xm, Mm, Mm, Mm, Mm, Mm^Xm, Mm^Xm, Hh, Hh
Gs, Gs, Gs, Gs, Hhd, Hh, Gs, Hhd, Gs, Gs, Hhd, Hhd, Hh, Gs, Gs, Hhd, Mm, Mm, Mm, Mm^Xm, Mm^Xm, Mm^Xm, Mm^Xm, Xu, Xos, Urb, Urb, Sm, Sm, Sm, Sm, Urb, Cud, 2 Kud, Cud, Urb, Uu, Uu, Urb, Urb, Cud, Xos, Xu, Xu, Xu, Xu, Mm^Xm, Mm, Mm^Xm, Mm^Xm, Mm^Xm, Mm, Mm, Mm^Xm, Mm, Mm, Mm^Xm, Mm, Mm, Mm^Xm, Mm
Gs, Hh, Hh, Gs, Gs, Hhd, Gs, Hhd, Gs, Hh, Gs, Hhd, Hhd, Hhd, Gs, Hh, Hh, Hh, Mm, Mm, Mm, Mm^Xm, Mm^Xm, Xu, Xu, Xos, Cud, Urb, Urb, Uu, Uu, Urb, Urb, Cud, Urb, Urb, Sm, Uu, Urb, Urb, Cud, Xos, Xu, Xu, Mm^Xm, Mm^Xm, Mm, Mm^Xm, Mm, Mm, Mm, Mm^Xm, Mm^Xm, Mm, Mm^Xm, Mm^Xm, Mm, Mm^Xm, Mm^Xm, Mm, Mm
Gs, Gs, Gs, Hh, Hh, Hhd, Gs, Hhd, Gs, Gs, Hhd, Gs, Gs, Hhd, Gs, Gs, Gs, Hhd, Hhd, Mm, Hh, Mm, Mm, Mm^Xm, Xu, Xos, Xos, Cud, Cud, Urb, Urb, Uu, Urb, Urb, Uu, Sm, Urb, Urb, Cud, Cud, Xos, Xos, Xu, Mm^Xm, Mm, Mm, Mm, Mm, Mm, Mm^Xm, Mm^Xm, Mm, Mm, Mm^Xm, Mm, Mm, Mm, Mm, Mm^Xm, Mm, Mm
Gs, Hh, Hhd, Hhd, Hh, Gs, Hhd, Hh, Hh, Hhd, Hh, Gs, Hh, Gs, Hh, Gs, Gs, Gs, Gs, Hh, Hh, Mm, Mm, Mm^Xm, Mm^Xm, Xu, Xu, Xos, Xos, Cud, Urb, Uu, Urb, Urb, Uu, Urb, Cud, Cud, Xos, Xos, Xu, Xu, Xu, Mm^Xm, Mm, Mm^Xm, Mm, Mm, Mm, Mm, Mm, Mm^Xm, Mm^Xm, Mm, Mm, Mm^Xm, Mm^Xm, Mm, Mm^Xm, Mm, Mm
Hh, Gs, Hhd, Gs, Gs, Gs, Gs, Hh, Gs, Hhd, Gs, Gs, Hhd, Gs, Gs, Hhd, Hhd, Gs, Hh, Gs, Hhd, Hhd, Hhd, Mm, Mm^Xm, Mm^Xm, Mm^Xm, Xu, Xu, Xos, Uu, Sm, Urb, Urb, Sm, Urb, Xos, Xos, Xu, Xu, Mm^Xm, Xu, Mm^Xm, Mm^Xm, Mm, Mm, Mm, Mm^Xm, Mm^Xm, Mm, Mm, Mm, Mm, Mm, Mm^Xm, Mm, Mm, Mm^Xm, Mm, Mm^Xm, Mm^Xm
Hhd, Gs, Gs, Gs, Hh, Hh, Gs, Gs, Hh, Hh, Hhd, Gs, Gs, Hhd, Hh, Gs, Hhd, Gs, Gs, Hhd, Gs, Gs, Hhd, Mm, Mm, Mm, Mm, Mm^Xm, Xu, Xos, Sm, Sm, Urb, Urb, Uu, Sm, Xos, Xu, Mm^Xm, Mm^Xm, Mm, Mm^Xm, Mm, Mm, Mm^Xm, Mm, Mm, Mm, Mm, Mm^Xm, Mm, Mm, Mm, Mm, Mm, Mm^Xm, Mm^Xm, Mm, Mm, Mm^Xm, Mm
Hh, Hhd, Gs, Hh, Hhd, Gs, Hhd, Gs, Gs, Hhd, Gs, Gs, Gs, Gs, Gs, Gs, Hh, Hh, Gs, Hhd, Hh, Gs, Gs, Hh, Hh, Mm, Mm, Mm^Xm, Xu, Xos, Uu, Uu, Urb, Urb, Sm, Sm, Sm, Xu, Mm, Mm, Mm, Mm, Mm, Mm, Mm, Mm^Xm, Mm^Xm, Mm, Mm, Mm, Mm, Mm^Xm, Mm^Xm, Mm, Mm, Mm, Mm, Mm, Mm, Mm, Mm
Gs, Gs, Hh, Gs, Hhd, Gs, Gs, Gs, Gs, Gs, Hhd, Hhd, Gs, Hhd, Ce, Ce, Ce, Hh, Gs, Gs, Gs, Hhd, Gs, Gs, Gs, Hhd, Hhd, Hh, Uu, Sm, Sm, Uu, Urb, Urb, Urb, Uu, Urb, Hh, Hh, Mm, Hh, Hh, Hhd, Mm, Mm, Mm, Mm, Mm, Mm, Mm, Mm, Mm, Mm, Mm^Xm, Mm, Mm, Mm^Xm, Mm, Mm, Mm^Xm, Mm
Hh, Gs, Hhd, Hhd, Hh, Gs, Gs, Hhd, Hhd, Gs, Gs, Gs, Ce, Gs, Urb, Urb, Urb, Ce, Urb, Ce, Urb, Ce, Ce, Ce, Urb, Urb, Urb, Uu, Urb, Urb, Urb, Urb, Urb, Urb, Cud, Urb, Cud, Urb, Urb, Ce, Ce, Ce, Hh, Mm, Mm, Mm, Mm, Mm, Mm, Mm, Mm, Mm, Mm, Mm, Mm, Mm, Mm, Mm^Xm, Mm^Xm, Mm, Mm
Hh, Hh, Gs, Hh, Gs, Hhd, Hhd, Gs, Gs, Gs, Gs, Ce, Urb, Urb, Urb, Urb, Rr^Rhx, Urb, Rr^Rhx, Urb, Urb, Urb, Urb, Urb, Cud, Cud, Cud, Urb, Qxua, Cud, Cud, Cud, Qxua, Cud, Qxua, Qxua, Qxua, Cud, Urb, Urb, Urb, Ce, Hh, Hh, Hhd, Hhd, Hh, Hh, Hh, Mm, Hhd, Mm, Hh, Mm, Mm, Mm, Mm, Mm^Xm, Mm^Xm, Mm, Mm
Gs^Ft, Gs^Ft, Gs, Hh, Hh, Hhd, Hhd, Hh, Ce, Ce, Urb, Urb, Rr^Rhx, Urb, Urb, Rr^Rhx, Rr^Vhc, Rr^Vhx, Rr^Rhx, Rr^Rhx, Rr^Vhx, Urb, Urb, Cud, Qxua, Qxua, Qxua, Qxua, Qxua, Qxua, Qxua, Qxua, Qxua, Qxua, Qxua, Qxua, Qxua, Cud, Cud, Urb, Cud, Urb, Urb, Ce, Ce, Ce, Urb, Ce, Ce, Hhd, Ce, Hh, Ce, Hhd, Hhd, Mm, Mm^Xm, Mm, Mm, Mm, Mm
Gs, Gs^Ft, Gs^Ft, Hhd, Hhd, Hhd, Hh, Gs, Ce, Urb, Urb, Rr^Rhx, Rr^Vhc, Rr^Rhx, Urb, Rr^Rhx, Rr^Rhx, Rr^Rhx, Urb, Rr^Rhx, Urb, Urb, Cud, Qxua, Qxua, Qxua, Qxua, Qxua, Qxua, Qxua, Qxua, Qxua, Qxua, Qxua, Qxua, Qxua, Qxua, Qxua, Qxua, Qxua, Qxua, Cud, Cud, Urb, Urb, Urb, Rr^Rhx, Urb, Urb, Urb, Urb, Urb, Urb, Ce, Hhd, Mm, Mm, Mm^Xm, Mm^Xm, Mm, Mm
Gs, Gs, Gs, Gs, Gs^Ft, Gs, Gs, Hh, Urb, Urb, Urb, Rr^Rhx, Rr^Vhx, Rr^Rhx, Urb, Urb, Urb, Urb, Rr^Vhx, Urb, Cud, Cud, Qxua, Qxua, Qxua, Qxua, Qxua, Qxua, Qxua, Qxua, Qxua, Qxua, Qxua, Qxua, Qxua, Qxua, Qxua, Qxua, Qxua, Qxua, Qxua, Qxua, Cud, Urb, Urb, Rr^Rhx, Rr^Rhx, Rr^Vhx, Rr^Rhx, Urb, Rr^Rhx, Rr^Rhx, Rr^Rhx, Urb, Ce, Hh, Mm, Mm, Mm, Mm, Mm
Gs^Ft, Gs^Ft, Gs^Ft, Gs, Gs, Gs^Ft, Gs, Ce, Urb, Urb, Rr^Rhx, Urb, Urb, Urb, Cud, Urb, Urb, Rr^Vhc, Rr^Rhx, Urb, Cud, Qxua, Qxua, Qxua, Qxua, Qxua, Qxua, Qxua, Qxua, Qxua, Qxua, Qxua, Qxua, Qxua, Qxua, Qxua, Qxua, Qxua, Qxua, Qxua, Qxua, Qxua, Qxua, Urb, Urb, Rr^Vhx, Rr^Rhx, Rr^Vhc, Rr^Rhx, Urb, Urb, Rr^Vhx, Rr^Rhx, Urb, Ce, Hh, Hh, Mm, Mm, Mm^Xm, Mm
Gs, Gs^Ft, Gs, Gs, Gs^Ft, Gs, Gs, Ce, Urb, Rr^Vhc, Rr^Rhx, Rr^Rhx, Urb, Cud, 4 Kud, Cud, Urb, Rr^Rhx, Rr^Vhx, Urb, Cud, Qxua, Qxua, Qxua, Qxua, Qxua, Qxua, Qxua, Qxua, Qxua, Qxua, Qxua, Qxua, Qxua, Qxua, Qxua, Qxua, Qxua, Qxua, Qxua, Qxua, Qxua, Qxua, Cud, Urb, Urb, Urb, Rr^Rhx, Urb, Urb, Urb, Rr^Rhx, Urb, Urb, Urb, Ce, Ce, Hhd, Hh, Mm, Mm
Gs, Gs^Ft, Gs^Ft, Gs, Gs, Gs^Ft, Gs, Ce, Urb, Rr^Rhx, Rr^Rhx, Rr^Vhx, Urb, Cud, Cud, Cud, Urb, Rr^Rhx, Urb, Urb, Cud, Qxua, Qxua, Qxua, Qxua, Qxua, Qxua, Qxua, Qxua, Qxua, Cud, Cud, Cud, Qxua, Qxua, Qxua, Qxua, Qxua, Qxua, Qxua, Qxua, Qxua, Qxua, Cud, Urb, Urb, Rr^Rhx, Urb, Urb, Urb, Cud, Urb, Urb, Urb, Rr^Rhx, Urb, Urb, Hhd, Hh, Hhd, Hhd
Gs, Gs, Gs, Gs^Ft, Gs, Gs^Ft, Gs^Ft, Gs, Ce, Urb, Urb, Rr^Rhx, Rr^Vhc, Urb, Urb, Urb, Rr^Vhx, Urb, Urb, Urb, Cud, Qxua, Qxua, Qxua, Qxua, Qxua, Qxua, Qxua, Qxua, Qxua, Cud, 3 Kud, Cud, Qxua, Qxua, Qxua, Qxua, Qxua, Qxua, Qxua, Qxua, Qxua, Cud, Cud, Urb, Rr^Vhx, Rr^Rhx, Rr^Rhx, Urb, Cud, 6 Kud, Cud, Urb, Rr^Vhc, Rr^Rhx, Rr^Rhx, Urb, Ce, Hhd, Hh, Gs
Gs^Ft, Gs^Ft, Gs, Gs^Ft, Gs, Gs, Gs, Gs, Gs, Ce, Urb, Rr^Rhx, Rr^Rhx, Rr^Rhx, Urb, Rr^Rhx, Rr^Vhc, Rr^Rhx, Urb, Urb, Urb, Cud, Qxua, Qxua, Qxua, Qxua, Qxua, Qxua, Qxua, Qxua, Qxua, Cud, Qxua, Qxua, Qxua, Qxua, Qxua, Qxua, Qxua, Qxua, Qxua, Qxua, Cud, Urb, Urb, Rr^Rhx, Rr^Rhx, Rr^Vhc, Urb, Cud, Cud, Cud, Urb, Rr^Rhx, Rr^Vhx, Rr^Rhx, Urb, Ce, Gs, Gs, Gs
Gs^Ft, Gs^Ft, Gs, Gs, Gs^Ft, Gs^Ft, Gs^Ft, Gs, Gs, Ce, Urb, Rr^Rhx, Rr^Rhx, Rr^Vhx, Urb, Rr^Rhx, Rr^Rhx, Rr^Rhx, Urb, Urb, Urb, Urb, Qxua, Qxua, Qxua, Qxua, Qxua, Qxua, Qxua, Qxua, Qxua, Qxua, Qxua, Qxua, Qxua, Qxua, Qxua, Qxua, Qxua, Qxua, Qxua, Qxua, Urb, Urb, Urb, Rr^Rhx, Rr^Vhx, Rr^Rhx, Urb, Urb, Urb, Urb, Urb, Urb, Urb, Rr^Rhx, Urb, Ce, Gs, Gs^Ft, Gs^Ft
Gs, Gs^Ft, Gs^Ft, Gs^Ft, Gs, Gs^Ft, Gs, Gs^Ft, Gs^Ft, Gs, Ce, Urb, Urb, Urb, Rr^Rhx, Urb, Urb, Urb, Urb, Urb, Cud, Urb, Cud, Qxua, Qxua, Qxua, Qxua, Qxua, Qxua, Qxua, Qxua, Qxua, Qxua, Qxua, Qxua, Qxua, Qxua, Qxua, Qxua, Qxua, Cud, Cud, Urb, Urb, Rr^Rhx, Urb, Urb, Urb, Urb, Rr^Rhx, Rr^Vhx, Rr^Rhx, Rr^Rhx, Urb, Urb, Urb, Ce, Gs, Gs^Ft, Gs^Ft, Gs
Gs, Gs, Gs, Gs, Gs, Gs, Gs^Ft, Gs^Ft, Gs^Ft, Gs, Ce, Urb, Urb, Urb, Rr^Rhx, Rr^Vhx, Rr^Rhx, Urb, Cud, Cud, Urb, Urb, Cud, Qxua, Qxua, Qxua, Qxua, Qxua, Qxua, Qxua, Qxua, Qxua, Qxua, Qxua, Qxua, Qxua, Qxua, Qxua, Qxua, Qxua, Cud, Urb, Urb, Rr^Rhx, Rr^Rhx, Rr^Rhx, Urb, Urb, Urb, Rr^Rhx, Rr^Rhx, Rr^Rhx, Rr^Rhx, Rr^Vhc, Urb, Urb, Ce, Gs, Gs^Ft, Gs, Gs^Ft
Gs^Ft, Gs^Ft, Gs^Ft, Gs^Ft, Gs^Ft, Gs, Gs^Ft, Gs, Gs, Gs, Gs, Ce, Ce, Urb, Urb, Rr^Rhx, Urb, Urb, Cud, Urb, Urb, Urb, Urb, Cud, Cud, Qxua, Cud, Qxua, Cud, Qxua, Qxua, Qxua, Qxua, Qxua, Qxua, Qxua, Cud, Qxua, Cud, Cud, Urb, Urb, Urb, Urb, Urb, Urb, Rr^Rhx, Rr^Rhx, Rr^Rhx, Urb, Rr^Rhx, Rr^Vhx, Rr^Rhx, Rr^Rhx, Urb, Urb, Gs, Gs^Ft, Gs, Gs^Ft, Gs
Gs, Gs, Gs, Gs, Gs, Gs^Ft, Gs, Gs, Gs^Ft, Gs^Ft, Gs^Ft, Gs, Gs, Gs, Ce, Urb, Urb, Urb, Urb, Urb, Rr^Rhx, Rr^Rhx, Rr^Vhx, Urb, Urb, Cud, Urb, Urb, Urb, Cud, Cud, Qxua, Qxua, Qxua, Cud, Cud, Urb, Urb, Urb, Urb, Urb, Urb, Urb, Cud, Cud, Urb, Urb, Rr^Vhx, Urb, Urb, Urb, Rr^Rhx, Urb, Urb, Ce, Gs, Gs^Ft, Gs^Ft, Gs, Gs^Ft, Gs
Gs, Gs^Ft, Gs^Ft, Gs^Ft, Gs, Gs^Ft, Gs^Ft, Gs^Ft, Gs^Ft, Gs, Gs, Gs^Ft, Gs, Gs, Gs, Gs, Cud, Urb, Urb, Urb, Rr^Rhx, Rr^Vhc, Rr^Rhx, Rr^Rhx, Rr^Rhx, Urb, Rr^Vhx, Rr^Rhx, Rr^Rhx, Urb, Urb, Cud, Urb, Cud, Urb, Urb, Urb, Rr^Rhx, Rr^Rhx, Urb, Rr^Rhx, Rr^Rhx, Rr^Vhx, Urb, Urb, Cud, Urb, Urb, Ce, Ce, Ce, Urb, Ce, Ce, Gs^Ft, Gs^Ft, Gs^Ft, Gs^Ft, Gs^Ft, Gs^Ft, Gs^Ft
Gs, Gs, Gs, Gs, Gs, Gs, Gs, Gs, Gs, Gs, Gs, Gs^Ft, Gs, Gs^Ft, Gs^Ft, Gs^Ft, Cud, Urb, Urb, Urb, Urb, Rr^Rhx, Rr^Rhx, Rr^Vhx, Rr^Rhx, Urb, Rr^Rhx, Rr^Rhx, Rr^Vhx, Rr^Rhx, Urb, Urb, Urb, Urb, Rr^Vhx, Urb, Rr^Rhx, Rr^Vhx, Rr^Rhx, Urb, Rr^Vhc, Rr^Rhx, Rr^Rhx, Urb, Urb, Cud, Urb, Urb, Gs^Ft, Gs, Gs, Gs^Ft, Gs, Gs^Ft, Gs, Gs, Gs, Gs, Gs^Ft, Gs^Ft, Gs
Gs, Gs^Ft, Gs^Ft, Gs^Ft, Gs, Gs^Ft, Gs^Ft, Gs^Ft, Gs^Ft, Gs, Gs^Ft, Gs, Gs, Gs, Gs, Cud, Urb, Urb, Rr^Vhx, Rr^Rhx, Rr^Rhx, Urb, Urb, Rr^Rhx, Urb, Urb, Urb, Rr^Rhx, Rr^Rhx, Rr^Vhc, Urb, Urb, Urb, Rr^Rhx, Rr^Rhx, Rr^Rhx, Rr^Rhx, Rr^Vhc, Urb, Urb, Rr^Vhx, Rr^Rhx, Rr^Rhx, Urb, Cud, Urb, Gs, Gs, Gs, Gs^Ft, Gs^Ft, Gs, Gs^Ft, Gs, Gs^Ft, Gs^Ft, Gs, Gs^Ft, Gs, Gs, Gs
Gs, Gs, Gs, Gs, Gs, Gs, Gs, Gs, Gs, Gs^Ft, Gs, Gs, Gs, Gs, Gs, Cud, Urb, Rr^Rhx, Rr^Vhc, Rr^Rhx, Rr^Rhx, Urb, Urb, Urb, Rr^Rhx, Rr^Rhx, Rr^Rhx, Urb, Urb, Urb, Cud, Urb, Cud, Urb, Urb, Rr^Rhx, Rr^Vhx, Rr^Rhx, Urb, Urb, Urb, Rr^Rhx, Urb, Urb, Cud, Gs, Gs^Ft, Gs^Ft, Gs^Ft, Gs, Gs, Gs^Ft, Gs, Gs^Ft, Gs, Gs, Gs^Ft, Gs, Gs^Ft, Gs^Ft, Gs
Gs, Gs, Gs, Gs, Gs, Gs, Gs, Gs, Gs, Gs, Gs, Gs, Gs, Gs, Gs, Cud, Urb, Rr^Rhx, Rr^Rhx, Rr^Vhx, Rr^Rhx, Rr^Rhx, Urb, Urb, Rr^Rhx, Rr^Rhx, Rr^Vhx, Urb, Urb, Cud, Cud, Cud, Cud, Cud, Urb, Rr^Rhx, Rr^Rhx, Urb, Urb, Urb, Urb, Urb, Urb, Urb, Cud, Gs, Gs, Gs^Ft, Gs, Gs^Ft, Gs^Ft, Gs^Ft, Gs, Gs, Gs^Ft, Gs^Ft, Gs, Gs^Ft, Gs^Ft, Gs^Ft, Gs^Ft
Gs, Gs, Gs, Gs, Gs, Gs, Gs, Gs, Gs, Gs, Gs, Gs, Gs, Gs, Gs, Gs, Cud, Urb, Urb, Rr^Rhx, Rr^Rhx, Rr^Vhc, Urb, Rr^Vhx, Rr^Rhx, Rr^Vhc, Rr^Rhx, Urb, Urb, Urb, Cud, 5 Kud, Cud, Urb, Urb, Urb, Urb, Urb, Rr^Rhx, Rr^Rhx, Rr^Rhx, Urb, Urb, Urb, Gs, Gs, Hh, Gs, Hhd, Gs, Gs, Gs, Hh, Gs^Ft, Gs, Gs, Gs, Gs^Ft, Gs^Ft, Gs, Gs
Gs, Gs, Gs, Gs, Gs, Gs, Gs, Gs, Gs, Gs, Gs, Gs, Gs, Gs, Gs, Gs, Gs, Gs, Cud, Urb, Urb, Urb, Urb, Urb, Urb, Rr^Rhx, Rr^Rhx, Rr^Rhx, Urb, Cud, Cud, Cud, Cud, Cud, Urb, Urb, Urb, Rr^Vhc, Rr^Rhx, Rr^Vhx, Urb, Urb, Gs, Cud, Gs, Hh, Hhd, Gs, Hhd, Hhd, Gs, Hh, Hh, Hh, Hhd, Hh, Hh, Gs, Hh, Gs, Gs
Gs, Gs, Gs, Gs, Gs, Gs, Gs, Gs, Gs, Gs, Gs, Gs, Gs, Gs, Gs, Gs, Gs, Gs, Cud, Urb, Urb, Urb, Urb, Urb, Cud, Urb, Urb, Urb, Urb, Urb, Urb, Urb, Urb, Urb, Urb, Urb, Urb, Urb, Urb, Urb, Cud, Cud, Gs, Gs, Hhd, Gs, Hhd, Gs, Hhd, Hhd, Hhd, Hhd, Hhd, Hhd, Gs, Gs, Hhd, Hh, Hh, Gs, Gs
Gs, Gs, Gs, Gs, Gs, Gs, Gs, Gs, Gs, Gs, Gs, Gs, Gs, Gs, Gs, Gs, Gs, Gs, Gs, Cud, Cud, Cud, Gs, Cud, Gs, Gs, Cud, Urb, Cud, Urb, Cud, Urb, Cud, Urb, Cud, Urb, Cud, Urb, Cud, Gs, Gs, Gs, Hhd, Hhd, Hhd, Hhd, Hhd, Hhd, Gs, Hhd, Hhd, Hhd, Hhd, Hhd, Hhd, Gs, Hhd, Hhd, Hhd, Gs, Gs
Gs, Gs, Gs, Gs, Gs, Gs, Gs, Gs, Gs, Gs, Gs, Gs, Gs, Gs, Gs, Gs, Gs, Gs, Gs, Gs, Gs, Gs, Gs, Gs, Gs, Gs, Gs, Cud, Gs, Gs, Gs, Cud, Gs, Gs, Gs, Gs, Gs, Cud, Gs, Gs, Hh, Hh, Hh, Hhd, Hhd, Gs, Hh, Hhd, Gs, Hh, Gs, Gs, Hhd, Hhd, Gs, Hhd, Hh, Gs, Hhd, Hh, Hh
Gs, Gs, Gs, Gs, Gs, Gs, Gs, Gs, Gs, Gs, Gs, Gs, Gs, Gs, Gs, Gs, Gs, Gs, Gs, Gs, Gs, Gs, Gs, Gs, Gs, Gs, Gs, Gs, Gs, Gs, Gs, Gs, Gs, Gs, Gs, Gs, Gs, Gs, Gs, Hh, Gg, Hh, Gg, Hhd, Gs, Gs, Gs, Hhd, Hhd, Gs, Hhd, Hh, Hh, Hh, Hh, Hh, Hh, Hh, Hh, Hhd, Gg
